border_size=1
usage=map

    Gs,    Gs,    Gs,    Gs,    Gs,    Gs,    Gs,    Gs,    Gs,    Gs,    Gs,    Gs,    Gs,    Gs,    Gs,    Gs,    Gs,    Gs,    Gs,    Gs,    Gs,    Gs,    Gs,    Gs,    Gs,    Rd,    Gs,    Gs,    Gs,    Gs,    Gs,    Gs,    Gs,    Gs,    Gs,    Gs,    Hh,    Gs,    Hh,    Gs,    Gs,    Gs,    Gs,    Gs,    Gs,    Gs,    Hh,    Gs,    Gs,    Mm,    Gs,    Gs
    Gs,    Gs,    Gs,    Gs,    Gs,    Gs,    Gs,    Gs,    Gs,    Gs,    Gs,    Gs,    Gs,    Gs,    Gs,    Gs,    Gs,    Gs,    Gs,    Gs,    Gs,    Gs,    Gs,    Gs,    Gs,    Rd,    Gs,    Gs,    Gs,    Gs,    Gs,    Gs,    Gs,    Gs,    Gs,    Gs,    Hh,    Gs,    Hh,    Gs,    Gs,    Gs,    Gs,    Gs,    Gs,    Gs,    Hh,    Gs,    Gs,    Mm,    Gs,    Gs
    Gs,    Gs,    Gs,    Gs,    Gs,    Gs,    Gs,    Gs,    Hh,    Gs,    Gs,    Hh,    Hh,    Gs,    Hh,    Hh,    Gs,    Gs,    Gs,    Gs,    Gs,    Gs,    Gs,    Gs,    Gs,    Rd,    Gs,    Gs,    Gs,    Gs,    Gs,    Gs,    Gs,    Gs,    Hh,    Hh,    Gs,    Gs,    Hh,    Hh,    Gs,    Gs,    Hh,    Hh,    Mm,    Hh,    Mm,    Hh,    Hh,    Gs,    Gs,    Gs
    Gs,    Gs,    Gs,    Gs,    Gs,    Gs,    Gs,    Hh,    Mm,    Hh,    Hh,    Hh,    Hh,    Hh,    Gs,    Gs,    Gs,    Gs,    Gs,    Gs,    Gs,    Gs,    Gs,    Gs,   Ycw,   Ycw,   Ycw,    Gs,    Gs,    Gs,    Gs,    Gs,    Gs,    Gs,    Gs,    Hh,    Hh,    Gs,    Gs,    Gs,    Hh,    Hh,    Mm,    Mm,    Gs,    Mm,    Gs,    Gs,    Gs,    Hh,    Hh,    Hh
    Gs,    Gs,    Gs,    Gs,    Gs,    Hh,    Mm,    Mm,    Mm,    Gs,    Gs,    Gs,    Gs,    Gs,    Gs,    Gs,    Gs,    Gs,    Gs,    Gs,   Ycw,    Gs,   Ycw,    Gs,   Ycw,    Ch,   Ycw,    Gs,   Ycw,    Gs,   Ycw,    Gs,    Gs,    Gs,    Hh,    Gs,    Gs,    Hh,    Gs,    Hh,    Hh,    Gs,    Hh,    Gs,    Hh,    Gs,    Hh,    Gs,    Hh,    Hh,    Hh,    Hh
    Gs,    Gs,    Gs,    Gs,    Hh,    Hh,    Mm,    Mm,    Hh,    Hh,    Gs,    Gs,    Gs,    Gs,    Gs,    Gs,   Ycw,   Ycw,   Ycw,   Ycw,    Rr,   Ycw,    Rr,   Ycw,    Rr,    Rr,    Rr,   Ycw,    Rr,   Ycw,    Rr,   Ycw,   Ycw,   Ycw,   Ycw,    Gs,    Gs,    Gs,    Gs,    Hh,    Gs,    Gs,    Gs,    Hh,    Hh,    Hh,    Hh,    Gs,    Gs,    Gs,    Gs,    Gs
    Gs,    Gs,    Gs,    Gs,    Hh,    Hh,    Mm,   Mm^Vhh,    Ss,    Gs,    Gs,    Gs,    Gs,    Gs,   Ycw,   Ycw,    Rr,   Ycw,    Rr,    Rr,    Rr,    Rr,   Gg^Vh,    Rr,    Rr,    Rr,    Rr,    Rr,   Gg^Vh,    Rr,    Rr,    Rr,    Rr,   Ycw,    Rr,   Ycw,    Hh,    Gs,    Gs,    Gs,    Gs,    Hh,    Hh,    Hh,    Gs,    Hh,    Hh,    Hh,    Gs,    Hh,    Hh,    Hh
    Gs,    Gs,    Gs,    Gs,    Gs,    Hh,    Mm,    Ss,    Ss,    Ss,    Gs,    Gs,   Ycw,   Ycw,    Rr,    Rr,   Gg^Vh,    Rr,   Ycw,   Gg^Vh,   Ycw,   Ycw,   Ycw,   Ycw,    Rr,    Rr,    Rr,   Ycw,   Ycw,   Ycw,   Ycw,   Gg^Vh,   Ycw,    Rr,   Gg^Vh,    Rr,    Rr,   Ycw,   Ycw,    Mm,    Gs,    Gs,    Mm,    Mm,    Mm,    Hh,    Hh,    Mm,    Hh,    Hh,    Hh,    Hh
    Gs,    Gs,    Gs,    Gs,    Gs,    Hh,    Mm,    Ss,    Hh,    Hh,    Gs,    Gs,   Ycw,    Rr,   Gg^Vh,    Rr,   Ycw,   Ycw,   Ycw,   Ycw,   Ycw,   Ycw,    Ch,   Ycw,    Rr,    Rr,    Rr,   Ycw,    Ch,   Ycw,   Ycw,   Ycw,   Ycw,   Ycw,   Ycw,    Rr,   Gg^Vh,    Rr,   Ycw,    Gs,    Hh,    Hh,    Mm,    Mm,    Mm,    Gs,    Hh,    Gs,    Gs,    Hh,    Gs,    Gs
    Gs,    Gs,    Gs,    Gs,    Hh,    Hh,    Gs,    Hh,    Hh,    Gs,    Gs,    Gs,   Ycw,    Rr,   Ycw,   Ycw,   Ycw,   Ycw,   Ycw,   Ycw,   Ycw,    Ch,  6 Kh,    Ch,    Rr,    Rr,    Rr,    Ch,  7 Kh,    Ch,   Ycw,   Ycw,   Ycw,   Ycw,   Ycw,   Ycw,   Ycw,    Rr,   Ycw,    Hh,    Hh,    Gs,    Gs,    Hh,    Gs,    Hh,    Gs,    Gs,    Hh,    Hh,    Hh,    Hh
    Gs,    Gs,    Gs,    Gs,    Hh,    Hh,    Hh,    Hh,    Gs,    Gs,    Gs,    Gs,   Ycw,    Rr,   Ycw,   Ycw,   Ycw,   Ycw,   Ycw,   Ycw,   Ycw,    Ch,    Ch,    Ch,    Rr,    Rr,    Rr,    Ch,    Ch,    Ch,   Ycw,   Ycw,   Ycw,   Ycw,   Ycw,   Ycw,   Ycw,    Rr,   Ycw,    Hh,    Hh,    Gs,    Gs,    Gs,    Hh,    Hh,    Gs,    Hh,    Gs,    Gs,    Gs,    Gs
    Gs,    Gs,    Gs,    Gs,    Gs,    Hh,    Hh,    Gs,    Gs,    Gs,    Gs,    Gs,   Ycw,    Rr,    Rr,    Rr,    Rr,    Rr,    Rr,    Rr,    Rr,    Rr,    Rr,    Rr,    Rr,    Rr,    Rr,    Rr,    Rr,    Rr,    Rr,    Rr,    Rr,    Rr,    Rr,    Rr,    Rr,    Rr,   Ycw,    Hh,    Hh,    Gs,    Hh,    Hh,    Hh,    Hh,    Gs,    Gs,    Gs,    Gs,    Gs,    Gs
    Gs,    Gs,    Gs,    Gs,    Gs,    Gs,    Gs,    Gs,    Gs,    Gs,    Gs,    Gs,   Ycw,    Rr,   Gg^Vh,    Rr,   Ycw,    Rr,   Gg^Vh,    Rr,   Ycw,    Rr,   Gg^Vh,    Rr,    Rr,    Rr,    Rr,    Rr,   Gg^Vh,    Rr,   Ycw,    Rr,   Gg^Vh,    Rr,   Ycw,    Rr,   Gg^Vh,    Rr,   Ycw,    Hh,    Hh,    Hh,    Mm,    Hh,    Hh,    Hh,    Hh,    Gs,    Gs,    Gs,    Gs,    Gs
    Gs,    Gs,    Gs,    Gs,    Gs,    Gs,    Gs,    Gs,    Gs,    Gs,    Gs,    Gs,   Ycw,    Rr,   Ycw,   Ycw,   Ycw,   Ycw,   Ycw,   Ycw,   Ycw,   Ycw,   Ycw,   Ycw,    Rr,    Rr,    Rr,   Ycw,   Ycw,   Ycw,   Ycw,   Ycw,   Ycw,   Ycw,   Ycw,   Ycw,   Ycw,    Rr,   Ycw,    Hh,    Hh,    Mm,    Mm,    Mm,    Hh,    Hh,    Hh,    Hh,    Gs,    Gs,    Gs,    Gs
    Gs,    Gs,    Gs,    Gs,    Gs,    Gs,    Gs,    Gs,    Gs,    Gs,    Gs,    Gs,   Ycw,    Rr,   Ycw,   Ycw,   Ycw,   Ycw,   Ycw,   Ycw,   Ycw,   Ycw,   Ycw,   Ycw,    Rr,    Rr,    Rr,   Ycw,   Ycw,   Ycw,   Ycw,   Ycw,   Ycw,   Ycw,   Ycw,   Ycw,   Ycw,    Rr,   Ycw,    Hh,    Hh,    Mm,    Mm,    Mm,    Hh,    Hh,    Hh,    Hh,    Hh,    Gs,    Gs,    Gs
    Gs,    Gs,    Gs,    Gs,    Gs,    Gs,   Ycw,   Ycw,   Ycw,    Gs,   Ycw,   Ycw,    Rr,    Rr,   Ycw,   Ycw,   Ycw,   Ycw,   Ycw,   Ycw,   Ycw,   Ycw,   Ycw,   Ycw,    Rr,    Rr,    Rr,   Ycw,   Ycw,   Ycw,   Ycw,   Ycw,   Ycw,   Ycw,   Ycw,   Ycw,   Ycw,    Rr,    Rr,   Ycw,   Ycw,    Mm,   Ycw,   Ycw,   Ycw,    Hh,    Hh,    Hh,    Hh,    Gs,    Gs,    Gs
    Gs,    Gs,    Gs,    Gs,    Gs,   Ycw,    Ch,    Ch,    Ch,   Ycw,    Rr,    Rr,    Rr,    Rr,   Ycw,   Ycw,   Ycw,   Ycw,   Ycw,   Ycw,   Ycw,   Ycw,   Ycw,   Ycw,    Rr,    Rr,    Rr,   Ycw,   Ycw,   Ycw,   Ycw,   Ycw,   Ycw,   Ycw,   Ycw,   Ycw,   Ycw,    Rr,    Rr,    Rr,    Rr,   Ycw,    Ch,    Ch,    Ch,   Ycw,    Hh,    Hh,    Hh,    Gs,    Gs,    Gs
    Gs,    Gs,    Gs,    Gs,    Gs,   Ycw,    Ch,  3 Kh,    Ch,    Rr,    Rr,    Rr,    Rr,    Rr,    Rr,   Gg^Vh,    Rr,   Ycw,    Rr,   Gg^Vh,    Rr,   Ycw,    Rr,   Gg^Vh,    Rr,    Rr,    Rr,   Gg^Vh,    Rr,   Ycw,    Rr,   Gg^Vh,    Rr,   Ycw,    Rr,   Gg^Vh,    Rr,    Rr,    Rr,    Rr,    Rr,    Rr,    Ch,  4 Kh,    Ch,   Ycw,    Gs,    Hh,    Gs,    Gs,    Gs,    Gs
    Gs,    Gs,    Gs,    Gs,    Gs,   Ycw,   Ycw,    Ch,    Rr,    Rr,    Rr,    Rr,    Rr,    Rr,    Rr,    Rr,    Rr,    Rr,    Rr,    Rr,    Rr,    Rr,    Rr,    Rr,    Ch,    Ch,    Ch,    Rr,    Rr,    Rr,    Rr,    Rr,    Rr,    Rr,    Rr,    Rr,    Rr,    Rr,    Rr,    Rr,    Rr,    Rr,    Rr,    Ch,   Ycw,   Ycw,    Gs,    Gs,    Gs,    Gs,    Gs,    Gs
    Gs,    Gs,    Gs,    Gs,    Gs,    Gs,   Ycw,   Ycw,   Ycw,    Rr,    Rr,    Rr,    Rr,    Rr,    Rr,    Rr,    Rr,    Rr,    Rr,    Rr,    Rr,    Rr,    Rr,    Rr,    Ch,  5 Kh,    Ch,    Rr,    Rr,    Rr,    Rr,    Rr,    Rr,    Rr,    Rr,    Rr,    Rr,    Rr,    Rr,    Rr,    Rr,    Rr,   Ycw,   Ycw,   Ycw,    Gs,    Gs,    Gs,    Gs,    Gs,    Gs,    Gs
    Gs,    Gs,    Gs,    Gs,    Gs,    Gs,    Gs,    Gs,    Hh,   Ycw,   Ycw,    Rr,    Rr,    Rr,   Ycw,   Gg^Vh,   Ycw,   Ycw,   Ycw,   Gg^Vh,   Ycw,   Ycw,   Ycw,   Gg^Vh,    Rr,    Ch,    Rr,   Gg^Vh,   Ycw,   Ycw,   Ycw,   Gg^Vh,   Ycw,   Ycw,   Ycw,   Gg^Vh,   Ycw,    Rr,    Rr,    Rr,   Ycw,   Ycw,    Gs,    Gs,    Gs,    Gs,    Gs,    Gs,    Gs,    Gs,    Gs,    Gs
    Gs,    Gs,    Gs,    Gs,    Gs,    Gs,    Hh,    Hh,    Hh,    Gs,    Gs,   Ycw,   Ycw,    Rr,   Ycw,   Ycw,   Ycw,   Ycw,   Ycw,   Ycw,   Ycw,   Ycw,   Ycw,   Ycw,    Rr,    Rr,    Rr,   Ycw,   Ycw,   Ycw,   Ycw,   Ycw,   Ycw,   Ycw,   Ycw,   Ycw,   Ycw,    Rr,   Ycw,   Ycw,    Gs,    Gs,    Gs,    Gs,    Gs,    Gs,    Gs,    Gs,    Gs,    Gs,    Gs,    Gs
    Gs,    Gs,    Gs,    Gs,    Gs,    Hh,    Hh,    Hh,    Hh,    Hh,    Gs,   Ycw,   Ycw,    Rr,   Ycw,   Ycw,   Ycw,   Ycw,   Ycw,   Ycw,   Ycw,   Ycw,   Ycw,   Ycw,    Rr,    Rr,    Rr,   Ycw,   Ycw,   Ycw,   Ycw,   Ycw,   Ycw,   Ycw,   Ycw,   Ycw,   Ycw,    Rr,   Ycw,   Ycw,    Gs,    Gs,    Gs,    Gs,    Gs,    Gs,    Gs,   Gs^Vht,    Gs,    Gs,    Gs,    Gs
    Gs,    Gs,    Gs,    Gs,    Gs,    Hh,    Hh,    Hh,    Hh,    Hh,    Gs,    Gs,   Ycw,    Rr,   Ycw,   Ycw,   Ycw,   Ycw,   Ycw,   Ycw,   Ycw,   Ycw,   Ycw,   Ycw,    Rr,    Rr,    Rr,   Ycw,   Ycw,   Ycw,   Ycw,   Ycw,   Ycw,   Ycw,   Ycw,   Ycw,   Ycw,    Rr,   Ycw,    Gs,    Gs,    Gs,    Gs,    Gs,    Gs,    Gs,    Gs,    Gs,    Gs,    Gs,    Gs,    Gs
    Gs,    Gs,    Gs,    Gs,    Hh,    Hh,    Hh,    Hh,    Hh,    Hh,    Hh,    Gs,   Ycw,    Rr,   Ycw,   Ycw,   Ycw,   Ycw,   Ycw,   Ycw,   Ycw,   Ycw,   Ycw,   Ycw,    Rr,    Rr,    Rr,   Ycw,   Ycw,   Ycw,   Ycw,   Ycw,   Ycw,   Ycw,   Ycw,   Ycw,   Ycw,    Rr,   Ycw,    Gs,    Gs,    Gs,    Gs,    Gs,    Gs,    Gs,    Gs,    Gs,    Gs,    Gs,    Gs,    Gs
    Gs,    Gs,    Gs,    Hh,    Gs,    Gs,    Gs,    Hh,    Gs,    Hh,    Gs,    Gs,   Ycw,    Rr,   Ycw,   Ycw,   Ycw,   Ycw,   Ycw,   Ycw,   Gg^Vh,   Ycw,    Rr,   Gg^Vh,    Rr,    Rr,    Rr,   Gg^Vh,    Rr,   Ycw,   Gg^Vh,   Ycw,   Ycw,   Ycw,   Ycw,   Ycw,   Ycw,    Rr,   Ycw,    Gs,    Gs,    Gs,    Gs^Ft,    Gs,    Gs^Ft,    Gs^Ft,    Gs,    Gs,    Gs,    Gs,    Gs,    Gs
    Gs,    Gs,    Gs,    Gs,    Gs,    Gs,    Gs,    Hh,    Hh,    Hh,    Gs,    Gs,   Ycw,    Rr,    Rr,   Ycw,   Gg^Vh,   Ycw,    Rr,    Rr,    Rr,    Rr,   Ycw,    Rr,    Rr,    Rr,    Rr,    Rr,   Ycw,    Rr,    Rr,    Rr,    Rr,   Ycw,   Gg^Vh,   Ycw,    Rr,    Rr,   Ycw,    Gs,    Gs,    Gs,    Gs,    Gs^Ft,    Gs^Ft,    Gs^Ft,    Gs^Ft,    Gs^Ft,    Gs,    Gs,    Gs,    Gs
    Gs,    Gs,    Gs,    Gs,    Gs,    Gs,    Gs,    Gs,    Gs,    Gs,    Gs,    Gs,    Gs,   Ycw,   Ycw,    Rr,    Rr,    Rr,   Ycw,   Ycw,   Ycw,   Ycw,   Ycw,   Ycw,   Ycw,    Rr,   Ycw,   Ycw,   Ycw,   Ycw,   Ycw,   Ycw,   Ycw,    Rr,    Rr,    Rr,   Ycw,   Ycw,    Gs,    Gs,    Gs,    Gs,    Gs,    Gs,    Gs,    Gs^Ft,    Gs^Ft,    Gs,    Gs,    Gs,    Gs,    Gs
    Gs,    Gs,    Gs,    Gs,    Gs,    Gs,    Gs,    Gs,    Gs,    Gs^Ft,    Gs,    Gs,    Gs,    Gs,    Gs,   Ycw,    Rr,   Ycw,    Gs,    Gs,    Gs,    Gs,    Gs,   Ycw,   Ycw,    Rr,   Ycw,   Ycw,    Gs,    Gs,    Gs,    Gs,    Gs,   Ycw,    Rr,   Ycw,    Gs,    Gs,    Gs,    Gs,    Gs,    Gs,    Gs,    Gs^Ft,    Gs^Ft,    Gs,    Gs,    Gs^Ft,    Gs,    Gs,    Gs,    Gs
    Gs,    Gs,    Gs,    Gs,    Gs,    Gs,    Gs,   Gs^Vht,    Gs,    Gs,    Gs,    Gs,    Gs,    Gs,    Gs,   Ycw,    Ch,   Ycw,    Gs,    Gs,    Gs,    Gs,    Gs,   Ycw,   Ycw,    Ch,   Ycw,   Ycw,    Gs,    Gs,    Gs,    Gs,    Gs,   Ycw,    Ch,   Ycw,    Gs,    Gs,    Gs,    Gs,    Gs,    Gs^Ft,    Gs,    Gs^Ft,    Gs,    Gs,    Gs,    Gs,   Gs^Vht,    Gs,    Gs,    Gs
    Gs,    Gs,    Gs,    Gs,    Gs,    Gs,    Gs,    Gs,    Gs,    Gs,    Gs,    Gs,    Gs,    Gs,    Gs,    Gs,    Gs,    Rd,    Rd,    Gs,    Gs^Ft,    Gs,    Gs,    Gs,    Gs,    Rd,    Gs,    Gs,    Gs,    Gs,    Gs,    Gs,    Rd,    Rd,    Gs,    Gs,    Gs,    Gs,    Gs,    Gs,    Gs^Ft,    Gs^Ft,   Gs^Vht,    Gs,    Gs^Ft,    Gs,    Gs^Ft,    Gs,    Gs^Ft,    Gs,    Gs,    Gs
    Gs,    Gs,    Gs,    Gs,    Gs,    Gs,    Gs,    Gs,    Gs,    Gs,    Gs,    Gs,    Gs,    Gs,    Gs,    Gs,    Gs^Ft,    Gs,    Gs^Ft,    Rd,    Rd,    Gs^Ft,    Gs,    Gs,    Gs,    Rd,    Gs,    Gs,    Gs,    Gs,    Rd,    Rd,    Gs,    Gs,    Gs,    Gs,    Gs,    Gs,    Gs,    Gs^Ft,    Gs,    Gs,    Gs,    Gs,    Gs,    Gs,    Gs,    Gs^Ft,    Gs,    Gs,    Gs,    Gs
    Gs,    Gs,    Gs,    Gs,   Gs^Vht,    Gs,    Gs,    Gs,    Gs,    Gs,    Gs,    Gs,    Gs^Ft,    Gs,    Gs^Ft,    Gs^Ft,    Gs^Ft,    Gs^Ft,    Gs^Ft,    Gs,    Gs,    Rd,    Rd,    Gs,    Gs,    Rd,    Gs,    Gs,    Rd,    Rd,    Gs,    Gs,    Gs,    Gs,    Gs,    Gs,    Gs^Ft,    Gs,    Gs,    Gs,    Gs^Ft,    Gs^Ft,    Gs^Ft,    Gs,    Gs,    Gs,    Gs^Ft,    Gs,    Gs,    Gs,    Gs,    Gs
    Gs,    Gs,    Gs,    Gs,    Gs,    Gs,    Gs^Ft,    Gs,    Gs,    Gs,    Gs,    Gs^Ft,    Gs,    Gs,    Gs,    Gs,    Gs,    Gs,    Gs,    Gs,    Gs,    Gs,    Gs,    Rd,    Rd,    Rd,    Rd,    Rd,    Gs,    Gs,    Gs,    Gs,    Gs,    Gs,    Gs,    Gs,    Gs,    Gs,   Gs^Vht,    Gs,    Gs,    Gs,    Gs^Ft,    Gs,    Gs,    Gs,    Gs,   Gs^Vht,    Gs,    Gs,    Gs^Ft,    Gs^Ft
    Gs,    Gs,    Gs,    Gs,    Gs,    Gs,    Gs,    Gs,    Gs,    Gs,    Gs,    Gs,    Gs,    Gs^Ft,    Gs^Ft,    Gs,    Gs^Ft,    Gs,    Gs^Ft,    Gs^Ft,    Gs^Ft,    Gs,    Gs,    Gs,    Rd,    Rd,    Rd,    Gs,    Gs,    Gs,    Gs,    Gs,    Gs,    Gs,    Gs,    Gs,    Gs^Ft,    Gs^Ft,    Gs,    Gs,    Gs,    Gs,    Gs,    Gs,    Gs,    Gs,    Gs,    Gs,    Gs,    Gs,    Gs,    Gs
    Gs,    Gs,    Gs,    Gs,    Gs,    Gs,    Gs^Ft,    Gs,    Gs^Ft,    Gs,    Gs^Ft,    Gs^Ft,    Gs^Ft,    Gs^Ft,    Gs^Ft,    Gs^Ft,    Gs^Ft,    Gs^Ft,    Gs^Ft,    Gs,    Gs,    Gs,    Gs,    Gs,    Rd,    Gs,    Gs,    Rd,    Rd,    Gs,    Gs,    Gs,    Gs,    Gs,    Gs,    Gs,    Gs,    Gs^Ft,    Gs,    Gs,    Gs,    Gs^Ft,    Gs,    Gs,    Gs,    Gs,    Gs,    Gs,    Gs,    Gs,    Gs,    Gs
    Gs,    Gs,    Gs,    Gs,    Gs^Ft,    Gs^Ft,    Gs^Ft,    Gs^Ft,    Gs^Ft,    Gs^Ft,    Gs^Ft,    Gs^Ft,    Gs^Ft,    Gs^Ft,    Gs^Ft,    Gs^Ft,    Gs^Ft,    Gs^Ft,    Gs^Ft,    Gs^Ft,    Gs,    Gs,    Gs,    Gs,    Rd,    Gs,    Gs,    Gs,    Gs,    Rd,    Rd,    Gs,    Gs,    Gs,    Gs,    Gs,    Gs,    Gs^Ft,    Gs,    Gs^Ft,   Gs^Vht,    Gs,    Gs,    Gs,    Gs,    Gs,   Gs^Vht,    Gs,    Gs,    Gs,    Gs,    Gs
    Gs,    Gs,    Gs,    Gs,    Gs^Ft,    Gs^Ft,    Gs^Ft,    Gs^Ft,    Gs^Ft,    Gs^Ft,    Gs^Ft,    Gs^Ft,    Gs^Ft,    Gs^Ft,    Gs^Ft,    Gs^Ft,    Gs,    Gs^Ft,    Gs,   Gs^Vht,    Gs,    Gs,    Gs,    Gs,    Rd,    Gs,    Gs,    Gs,    Gs,    Gs,    Gs,    Rd,    Rd,    Gs,    Gs,    Gs,    Gs,    Gs,    Gs,    Gs,    Gs^Ft,    Gs,    Gs,    Gs,    Gs,    Gs,    Gs,    Gs,    Gs,    Gs,    Gs,    Gs
    Gs,    Gs,    Gs^Ft,    Gs,    Gs^Ft,    Gs^Ft,    Gs^Ft,    Gs^Ft,    Gs^Ft,    Gs^Ft,    Gs^Ft,    Gs^Ft,    Gs^Ft,    Gs^Ft,    Gs^Ft,    Gs^Ft,    Gs^Ft,    Gs,    Gs,    Gs,    Gs,    Gs,    Gs,    Gs,    Rd,    Gs,    Gs,    Gs,    Gs,    Gs,    Gs,    Gs,    Gs,    Rd,    Rd,    Gs,    Gs,    Gs,    Gs,    Gs,    Gs,    Gs,    Gs,    Gs,    Gs,    Gs,    Gs,    Gs,    Gs,    Gs,    Gs,    Gs
    Gs,    Gs,    Gs,    Gs^Ft,    Gs^Ft,   Gs^Vht,    Gs^Ft,    Gs^Ft,    Gs^Ft,    Gs^Ft,    Gs^Ft,    Gs^Ft,    Gs^Ft,    Gs^Ft,    Gs^Ft,    Gs^Ft,    Gs,    Gs,    Gs,    Gs,    Gs,    Gs,    Gs,    Gs,    Rd,    Gs,    Gs,    Gs,    Gs^Ft,    Gs,    Gs,    Gs,    Gs,    Gs,    Gs,    Rd,    Rd,    Gs,    Gs,    Gs,    Gs,    Gs,    Gs,    Gs,    Gs,    Gs,    Gs,    Gs,    Gs,    Gs,    Gs,    Gs
    Gs,    Gs,    Gs,    Gs,    Gs,    Gs,    Gs^Ft,    Gs^Ft,    Gs^Ft,    Gs^Ft,    Gs^Ft,    Gs^Ft,    Gs^Ft,    Gs^Ft,   Gs^Vht,    Gs^Ft,    Gs,    Gs,    Gs,    Gs,    Gs,    Gs,    Gs,    Gs,    Ce,    Gs,    Gs,    Gs^Ft,    Gs^Ft,    Gs,    Gs,    Gs,    Gs,    Gs,    Gs,    Gs,    Gs,    Rd,    Rd,    Gs,    Gs,    Gs,    Gs,    Gs,    Gs,    Gs,    Gs,    Gs,    Gs,    Gs,    Gs,    Gs
    Gs^Ft,    Gs^Ft,    Gs,    Gs,    Gs^Ft,    Gs^Ft,    Gs^Ft,    Gs^Ft,    Gs^Ft,    Gs^Ft,    Gs^Ft,    Gs^Ft,    Gs^Ft,    Gs^Ft,    Gs^Ft,    Gs^Ft,    Gs^Ft,    Gs,    Gs,    Gs,    Gs,    Gs,    Gs,    Ce,  2 Ke,    Ce,    Gs,    Gs,    Gs^Ft,    Gs,    Gs,    Gs,   Gs^Vht,    Gs,    Gs,    Gs,    Gs,    Gs,    Gs,    Rd,    Rd,    Gs,    Ce,    Gs,    Gs,    Gs,    Gs,    Gs,    Gs^Ft,    Gs,    Gs,    Gs
    Gs,    Gs,    Gs,    Gs,    Gs,    Gs^Ft,    Gs^Ft,    Gs^Ft,    Gs,    Gs,    Gs^Ft,    Gs^Ft,    Gs^Ft,    Gs^Ft,    Gs^Ft,    Gs^Ft,    Gs^Ft,    Gs,    Gs,    Gs,    Gs,    Gs,    Gs,    Ce,    Ce,    Ce,    Gs,    Gs,    Gs^Ft,    Gs,    Gs,    Gs,    Gs,    Gs,    Gs,    Gs,    Gs,    Gs,    Gs,    Gs,    Gs,    Ce,  1 Ke,    Ce,    Gs,    Gs,    Gs,    Gs,    Gs,    Gs,    Gs,    Gs
    Gs,    Gs,    Gs,    Gs,    Gs,    Gs,    Gs,    Gs^Ft,    Gs^Ft,   Gs^Vht,    Gs^Ft,    Gs^Ft,    Gs^Ft,    Gs^Ft,    Gs,    Gs,    Gs,   Gs^Vht,    Gs,    Gs,    Gs,    Gs,    Gs,    Gs,    Rd,    Gs,    Gs,    Gs,    Gs,    Gs^Ft,    Gs^Ft,    Gs^Ft,    Gs,    Gs,    Gs^Ft,    Gs,    Gs,    Gs,    Gs,    Gs,    Gs,    Ce,    Ce,    Ce,    Gs,    Gs,    Gs,    Gs,    Gs,    Gs,    Gs,    Gs
    Gs,    Gs,    Gs,    Gs,    Gs,    Gs,    Gs,    Gs,    Gs^Ft,    Gs^Ft,    Gs^Ft,    Gs,    Gs,    Gs^Ft,    Gs,    Gs,    Gs,    Gs,    Gs,    Gs,    Gs,    Gs,    Gs,    Gs,    Rd,    Gs,   Gs^Vht,    Gs,    Gs,    Gs,    Gs,    Gs,    Gs,    Gs,    Gs,    Gs,    Gs,    Gs,    Gs,    Gs,    Gs,    Gs,    Rd,    Gs,    Gs,    Gs,    Gs,    Gs,    Gs,    Gs,    Gs,    Gs
    Gs,    Gs,    Gs,    Gs,    Gs,    Gs,    Gs,    Gs,    Gs^Ft,    Gs^Ft,    Gs^Ft,    Gs,    Gs^Ft,    Gs^Ft,    Gs^Ft,    Gs,    Gs,    Gs,    Gs,    Gs,    Gs,    Gs,    Gs,    Gs,    Rd,    Gs,    Gs,    Gs,    Gs,    Gs,    Gs,    Gs,    Gs,    Gs,    Gs,    Gs,    Gs,    Gs,    Gs,    Gs,    Gs,    Gs,    Rd,    Gs,    Gs,    Gs,    Gs,    Gs,   Gs^Vht,    Gs,    Gs,    Gs
    Gs,    Gs,    Gs,    Gs,    Gs,    Gs,    Gs,    Gs,    Gs,    Gs^Ft,    Gs,    Gs,    Gs,    Gs,    Gs^Ft,    Gs,    Gs,    Gs,    Gs,    Gs,    Gs,    Gs,    Gs,    Gs,    Rd,    Gs,    Gs,    Gs,    Gs,    Gs,    Gs,    Gs,    Gs,    Gs,    Gs,    Gs,    Gs,    Gs,    Gs,    Gs,    Gs,    Gs,    Rd,    Gs,    Gs,    Gs,    Gs,    Gs,    Gs,    Gs,    Gs,    Gs
    Gs,    Gs,    Gs,    Gs,    Gs,    Gs,    Gs,    Gs,    Gs,    Gs,    Gs,    Gs,    Gs,    Gs,    Gs,    Gs,    Gs,    Gs,    Gs,    Gs,    Gs,    Gs,    Gs,    Gs,    Rd,    Gs,    Gs,    Gs,    Gs,    Gs,    Gs,    Gs,    Gs,    Gs,    Gs,    Gs,    Gs,    Gs,    Gs,    Gs,    Gs,    Gs,    Rd,    Gs,    Gs,    Gs,    Gs,    Gs,    Gs,    Gs,    Gs,    Gs
    Gs,    Gs,    Gs,    Gs,    Gs,    Gs,    Gs,    Gs,    Gs,    Gs,    Gs,    Gs,    Gs,    Gs,    Gs,    Gs,    Gs,    Gs,    Gs,    Gs,    Gs,    Gs,    Gs,    Gs,    Rd,    Gs,    Gs^Ft,    Gs,    Gs,    Gs,    Gs,    Gs,    Gs,    Gs,    Gs,    Gs,    Gs,    Gs,    Gs,    Gs,    Gs^Ft,    Gs,    Rd,    Gs,    Gs,    Gs,    Gs,    Gs,    Gs^Ft,    Gs,    Gs,    Gs
    Gs,    Gs,    Gs,    Gs,    Gs,    Gs,    Gs,    Gs,    Gs,    Gs,    Gs,    Gs,    Gs,    Gs,    Gs,    Gs,    Gs,    Gs,    Gs,    Gs,    Gs,    Gs,    Gs,    Gs,    Rd,    Gs,    Gs,    Gs,    Gs,    Gs,    Gs,    Gs,    Gs,    Gs,    Gs,    Gs,    Gs,    Gs,    Gs,    Gs,    Gs,    Gs,    Rd,    Gs,    Gs,    Gs,    Gs,    Gs,    Gs,    Gs,    Gs,    Gs
    Gs,    Gs,    Gs,    Gs,    Gs,    Gs,    Gs,    Gs,    Gs,    Gs,    Gs,    Gs,    Gs,    Gs,    Gs,    Gs,    Gs,    Gs,    Gs,    Gs,    Gs,    Gs,    Gs,    Gs,    Rd,    Gs,    Gs,    Gs,    Gs,    Gs,    Gs,    Gs,    Gs,    Gs,    Gs,    Gs,    Gs,    Gs,    Gs,    Gs,    Gs,    Gs,    Rd,    Gs,    Gs,    Gs,    Gs,    Gs,    Gs,    Gs,    Gs,    Gs
    Gs,    Gs,    Gs,    Gs,    Gs,    Gs,    Gs,    Gs,    Gs,    Gs,    Gs,    Gs,    Gs,    Gs,    Gs,    Gs,    Gs,    Gs,    Gs,    Gs,    Gs,    Gs,    Gs,    Gs,    Rd,    Gs,    Gs,    Gs,    Gs,    Gs,    Gs,    Gs,    Gs,    Gs,    Gs,    Gs,    Gs,    Gs,    Gs,    Gs,    Gs,    Gs,    Rd,    Gs,    Gs,    Gs,    Gs,    Gs,    Gs,    Gs,    Gs,    Gs
