border_size=1
usage=map

    Wo,    Wo,    Wo,    Wo,    Wo,    Wo,    Wo,    Wo,    Wo,    Wo,    Wo,    Wo,    Wo,    Wo,    Wo,    Wo,    Wo,    Wo,    Wo,    Wo,    Wo,    Wo,    Wo,    Wo,    Wo,    Wo,    Wo,    Wo,    Wo,    Wo,    Wo,    Wo,    Wo,    Wo,    Wo,    Wo,    Wo,    Wo,    Wo,    Wo,    Wo,    Wo,    Wo,    Wo,    Wo,    Wo,    Wo,    Wo,    Wo,    Wo,    Wo,    Wo
    Wo,    Wo,    Wo,    Wo,    Wo,    Wo,    Wo,    Wo,    Wo,    Wo,    Wo,    Wo,    Wo,    Wo,    Wo,    Wo,    Wo,    Wo,    Wo,    Wo,    Wo,    Wo,    Wo,    Wo,    Wo,    Wo,    Wo,    Wo,    Wo,    Wo,    Wo,    Wo,    Wo,    Wo,    Wo,    Wo,    Wo,    Wo,    Wo,    Wo,    Wo,    Wo,    Wo,    Wo,    Wo,    Wo,    Wo,    Wo,    Wo,    Wo,    Wo,    Wo
    Wo,    Wo,    Wo,    Wo,    Wo,    Wo,    Wo,    Wo,    Wo,    Wo,    Wo,    Wo,    Wo,    Wo,    Wo,    Wo,    Wo,    Wo,    Wo,    Wo,    Wo,    Wo,    Wo,    Wo,    Wo,    Wo,    Wo,    Wo,    Wo,    Wo,    Wo,    Wo,    Wo,    Wo,    Wo,    Wo,    Wo,    Wo,    Wo,    Wo,    Wo,    Wo,    Wo,    Wo,    Wo,    Wo,    Wo,    Wo,    Wo,    Wo,    Wo,    Wo
    Wo,    Wo,    Wo,    Wo,    Wo,    Wo,    Wo,    Wo,    Wo,    Wo,    Wo,    Wo,    Wo,    Wo,    Wo,    Wo,    Wo,    Wo,    Wo,    Wo,    Wo,    Wo,    Wo,    Wo,    Wo,    Wo,    Wo,    Wo,    Wo,    Wo,    Wo,    Wo,    Wo,    Wo,    Wo,    Wo,    Wo,    Wo,   Ww^Vm,    Wo,    Wo,    Wo,    Wo,    Wo,    Wo,    Wo,    Wo,    Wo,    Wo,    Wo,    Wo,    Wo
    Wo,    Wo,    Wo,    Wo,    Wo,    Wo,    Wo,    Wo,    Wo,    Wo,    Wo,    Wo,    Wo,    Wo,    Wo,    Wo,    Wo,    Wo,    Wo,    Wo,    Wo,    Wo,    Wo,    Wo,    Wo,    Wo,    Wo,    Wo,    Wo,    Wo,    Wo,    Wo,    Wo,    Wo,    Wo,    Wo,    Wo,    Wo,    Wo,    Wo,    Wo,    Wo,    Wo,    Wo,    Wo,    Wo,    Wo,    Wo,    Wo,    Wo,    Wo,    Wo
    Wo,    Wo,    Wo,    Wo,    Wo,    Wo,    Wo,    Wo,    Wo,    Wo,    Wo,    Wo,    Wo,    Wo,    Wo,    Wo,    Wo,    Wo,    Wo,    Wo,    Wo,    Wo,    Wo,    Wo,    Wo,    Wo,    Wo,    Wo,    Wo,    Wo,    Wo,    Wo,    Wo,    Wo,    Wo,    Wo,    Wo,    Wo,    Wo,    Wo,    Wo,    Wo,    Wo,    Wo,    Wo,    Wo,    Wo,    Wo,    Wo,    Wo,    Wo,    Wo
    Wo,    Wo,    Wo,    Wo,    Wo,    Wo,    Wo,    Wo,    Wo,    Wo,    Wo,    Wo,    Wo,    Wo,    Wo,    Wo,    Wo,    Wo,    Wo,    Wo,    Wo,    Wo,    Wo,    Wo,    Wo,    Wo,    Wo,    Wo,    Wo,    Wo,    Wo,    Wo,    Wo,    Wo,    Wo,    Wo,    Wo,    Wo,    Wo,    Wo,    Wo,    Wo,    Wo,    Wo,    Wo,    Wo,    Wo,    Wo,    Wo,    Wo,    Wo,    Wo
    Wo,    Wo,    Wo,    Wo,    Wo,    Wo,    Wo,    Wo,    Wo,    Wo,    Wo,   Ww^Vm,    Wo,    Wo,    Wo,    Wo,    Wo,    Wo,    Wo,    Wo,    Ww,    Ww,    Ww,    Ww,    Wo,    Wo,    Wo,    Wo,    Wo,    Wo,    Wo,    Wo,    Wo,    Wo,    Wo,    Wo,    Wo,    Wo,    Wo,    Wo,    Wo,    Wo,    Wo,    Wo,    Wo,    Wo,    Wo,    Wo,    Wo,    Wo,    Wo,    Wo
    Wo,    Wo,    Wo,    Wo,    Wo,    Wo,    Wo,    Wo,    Wo,    Wo,    Wo,    Wo,    Wo,    Wo,    Wo,    Wo,    Wo,    Wo,    Wo,    Ww,    Gg,    Ds,    Ds,    Ww,    Wo,    Wo,    Wo,    Wo,    Wo,    Wo,    Wo,    Wo,    Wo,    Wo,    Wo,    Wo,    Wo,    Wo,    Wo,    Wo,    Wo,    Wo,    Wo,    Wo,    Wo,    Wo,    Wo,    Wo,    Wo,    Wo,    Wo,    Wo
    Wo,    Wo,    Wo,    Wo,    Wo,    Wo,    Wo,    Wo,    Wo,    Wo,    Wo,    Wo,    Wo,    Wo,    Wo,    Wo,    Wo,    Ww,    Ww,    Ds,    Gg,    Gg,    Ww,    Ww,    Wo,    Wo,    Wo,    Wo,    Wo,    Wo,    Wo,    Wo,    Wo,    Wo,    Wo,    Wo,    Wo,    Wo,    Wo,    Wo,    Wo,    Wo,    Wo,    Wo,    Wo,    Wo,    Wo,    Wo,    Wo,    Wo,    Wo,    Wo
    Wo,    Wo,    Wo,    Wo,    Wo,    Wo,    Wo,    Wo,    Wo,    Wo,    Wo,    Wo,    Wo,    Wo,    Wo,    Wo,    Wo,    Wo,    Ww,    Ds,    Ds,    Ds,    Ww,    Wo,    Wo,    Wo,    Wo,    Wo,    Wo,    Wo,    Wo,    Wo,    Wo,    Wo,    Wo,    Wo,    Wo,    Wo,    Wo,    Wo,    Wo,    Wo,    Wo,    Wo,    Wo,    Wo,    Wo,    Wo,    Wo,    Wo,    Wo,    Wo
    Wo,    Wo,    Wo,    Wo,    Wo,    Wo,    Wo,    Wo,    Wo,    Wo,    Wo,    Wo,    Wo,    Wo,    Wo,    Wo,    Wo,    Wo,    Wo,    Wo,    Ww,    Ww,    Wo,    Wo,    Wo,    Wo,    Wo,    Wo,    Wo,    Wo,    Wo,    Wo,    Wo,    Wo,    Wo,    Wo,    Wo,    Wo,    Wo,    Wo,    Wo,    Wo,    Wo,    Wo,    Wo,    Wo,    Wo,    Wo,    Wo,    Wo,    Wo,    Wo
    Wo,    Wo,    Wo,    Wo,    Wo,    Wo,    Wo,    Wo,    Wo,    Wo,    Wo,    Wo,    Wo,    Wo,    Wo,    Wo,    Wo,    Wo,    Wo,    Wo,    Wo,    Wo,    Wo,    Wo,    Wo,    Wo,    Wo,    Wo,    Wo,    Wo,    Wo,    Wo,    Wo,    Wo,    Wo,    Wo,    Wo,    Wo,    Wo,    Wo,    Wo,    Wo,    Wo,    Wo,    Wo,    Wo,    Wo,    Wo,   Ww^Vm,    Wo,    Wo,    Wo
    Wo,    Wo,    Wo,    Wo,   Ww^Vm,    Wo,    Wo,    Wo,    Wo,    Wo,    Wo,    Wo,    Wo,    Wo,    Wo,    Wo,    Wo,    Wo,    Wo,    Wo,    Wo,    Wo,    Wo,    Wo,    Wo,    Wo,    Wo,    Wo,    Wo,    Wo,    Wo,    Wo,    Wo,    Wo,   Ww^Vm,    Wo,    Wo,    Wo,    Wo,    Wo,    Wo,    Wo,    Wo,    Wo,    Wo,    Wo,    Wo,    Wo,    Wo,    Wo,    Wo,    Wo
    Wo,    Wo,    Wo,    Wo,    Wo,    Wo,    Wo,    Wo,    Wo,    Wo,    Wo,    Wo,    Wo,    Wo,    Wo,    Wo,    Wo,    Wo,    Wo,    Wo,    Wo,    Wo,    Wo,    Wo,    Wo,    Wo,    Wo,    Wo,    Wo,    Wo,    Wo,    Wo,    Wo,    Wo,    Wo,    Wo,    Wo,    Wo,    Wo,    Wo,    Wo,    Wo,    Wo,    Wo,    Wo,    Wo,    Wo,    Wo,    Wo,    Wo,    Wo,    Wo
    Wo,    Wo,    Wo,    Wo,    Wo,    Wo,    Wo,    Wo,    Wo,    Wo,    Wo,    Wo,    Wo,    Wo,    Wo,    Wo,    Wo,    Wo,    Wo,    Wo,    Wo,    Wo,    Wo,    Wo,    Wo,    Wo,    Wo,    Wo,    Wo,    Wo,    Wo,    Wo,    Wo,    Wo,    Wo,    Wo,    Wo,    Wo,    Wo,    Wo,    Wo,    Wo,    Wo,    Wo,    Wo,    Wo,    Wo,    Wo,    Wo,    Wo,    Wo,    Wo
    Wo,    Wo,    Wo,    Wo,    Wo,    Wo,    Wo,    Wo,    Wo,    Wo,    Wo,    Wo,    Wo,    Wo,    Wo,    Wo,    Ww,    Wo,    Wo,    Wo,    Wo,    Wo,    Wo,    Wo,    Ww,    Wo,    Wo,    Wo,    Wo,    Wo,    Wo,    Wo,    Wo,    Wo,    Wo,    Wo,    Wo,    Wo,    Wo,    Wo,    Wo,    Wo,    Wo,    Wo,    Wo,    Wo,    Wo,    Wo,    Wo,    Wo,    Wo,    Wo
    Wo,    Wo,    Wo,    Wo,    Ww,    Wo,    Wo,    Wo,    Wo,    Ww,    Wo,    Wo,    Wo,    Wo,    Wo,    Wo,    Wo,    Ww,    Wo,    Ww,    Wo,    Wo,    Wo,    Wo,    Ww,    Wo,    Wo,    Ww,    Ww,    Wo,    Wo,    Wo,    Wo,    Wo,    Wo,    Wo,    Ww,    Wo,    Wo,    Wo,    Wo,    Wo,    Wo,    Wo,  Ww^Bw\,    Wo,    Wo,    Wo,    Ww,    Wo,    Wo,    Wo
    Ww,    Ww,    Ww,    Ww,    Ww,    Ww,    Ww,    Ds,    Ww,    Ww,    Ww,    Ww,    Ww,    Ww,    Ww,    Wo,    Ww,    Ww,    Ww,    Ww,    Ww,    Ww,    Ww,    Ww,    Ds,    Ww,    Ww,    Ww,    Ww,    Ww,    Ww,    Ww,    Ww,    Ds,    Ww,    Ww,    Ww,    Ww,    Ww,    Ww,    Ww,    Ww,    Ww,    Ww,   Chw,  4 Khw,   Chw,    Ww,    Ww,    Ww,    Ww,    Ww
    Ds,    Ds,    Ds,    Ds,    Ds,    Ds,    Ds,    Ds,    Ds,    Ds,    Ds,    Ww,    Ww,    Ww,    Ww,    Wo,    Wo,    Ww,    Ww,    Ds,    Ds,    Ds,    Ds,    Ds,    Ds,    Ds,    Ds,    Ww,    Ds,    Ds,    Ds,    Ds,    Ds,    Ds,    Ds,    Ds,    Ds,    Ds,    Ds,    Ds,    Ds,    Ds,    Ds,    Gg,   Chr,   Chr,   Chr,    Gg,    Ds,    Ds,    Ds,    Ds
    Gg,    Gg,    Gg,    Gg,    Gg,    Ds,    Gg,    Gg,    Gg,    Gg,    Gg,    Ww,    Ww,    Ww,    Ww,    Wo,    Wo,    Ww,    Ww,    Gg,    Gg,    Gg,    Gg,    Gg,    Gg,    Gg,    Gg,    Ds,    Ds,    Gg,    Gg,    Gg,    Gg,    Gg,    Ds,    Gg,    Gg,    Gg,    Gg,    Gg,    Gg,    Ds,    Gg,    Gg,    Gg,   Chr,    Gg,    Gg,    Gg,    Gg,    Gg,    Gg
    Gg,    Gg,    Gg,    Gg,    Gg,    Gg,   Chr,   Chr,   Chr,    Gg,    Gg,    Ww,    Ww,    Ww,    Ww,    Wo,    Ww,    Ww,  Ww^Bw/,   Chr,    Gg,    Gg,    Gg,    Gg,    Gg,    Gg,    Gg,    Gg,    Gg,    Gg,    Gg,    Gg,    Gg,    Gg,    Gg,    Gg,    Gg,    Gg,    Gg,    Gg,    Gg,    Gg,    Gg,    Gg,    Gg,    Gg,    Gg,    Gg,    Gg,    Gg,    Gg,    Gg
    Gg,    Gg,    Gg,    Gg,    Gg,    Gg,   Chr,  3 Khr,   Chr,    Gg,    Gg,    Gg,    Ww,    Ww,   Ww^Vm,    Wo,  Ww^Bw/,  Ww^Bw/,    Ww,    Gg,    Gg,    Gg,    Gg,    Gg,    Gg,    Gg,    Gg,    Gg,    Gg,    Gg,    Gg,   Gg^Vh,    Gg,    Gg,    Gg,    Gg,    Gg,    Gg,    Gg,    Gg,    Gg,    Gg,    Gg,    Gg,    Gg,    Gg,    Gg,    Gg,    Gg,    Gg,    Gg,    Gg
    Gg,    Gg,    Gg,    Gg,    Gg,    Gg,    Gg,   Chr,    Gg,    Gg,    Gg,    Gg,    Gg,    Ww,  Ww^Bw/,  Ww^Bw/,    Wo,    Ww,   Ww^Vm,    Ww,    Ww,    Gg,    Gg,    Gg,    Gg,    Gg,    Gg,    Gg,    Gg,    Gg,    Gg,    Gg,    Gg,    Gg,    Gg,    Gg,    Gg,    Gg,    Gg,    Gg,   Gg^Ve,    Gg,    Gg,    Gg,    Gg,    Gg,    Gg,    Gg,    Gg,    Gg,    Gg,    Gg
    Gg,    Gg,    Gg,    Gg,    Gg,    Gg,    Gg,    Gg,    Gg,    Gg,    Gg,    Gg,   Chr,  Ww^Bw/,    Ww,    Ww,    Wo,    Ww,    Ww,    Ww,    Ww,    Ww,    Ww,    Gg,    Gg,    Gg,    Gg,    Gg,    Gg,    Gg,    Gg,   Gg^Ve,    Gg,    Gg,    Gg,    Gg,    Gg,    Gg,    Gg,    Gg,    Gg,    Gg,    Gg,    Gg,    Gg,    Gg,    Gg,    Gg,    Gg,    Gg,    Gg,    Gg
    Gg,    Gg,    Gg,    Gg,    Gg,    Gg,    Gg,    Gg,    Gg,    Gg,    Gg,    Gg,    Gg,    Ww,    Ww,    Ww,    Wo,    Wo,    Wo,    Ww,    Ww,    Ww,    Ww,    Gg,    Gg,    Gg,    Gg,    Gg,    Gg,    Gg,    Gs^Fp,    Gg,    Gg,    Gg,    Gg,    Gg,    Gg,    Gg,    Gg,    Gg,    Gg,    Gg,    Gg,    Gg,    Gg,    Gg,    Gg,    Gg,    Gg,    Gg,    Gg,    Gg
    Gg,    Gg,    Gg,    Gg,    Gg,    Gg,    Gg,    Gg,    Gg,    Gg,   Gg^Ve,    Gg,    Gg,    Ww,    Ww,    Ww,    Ww,    Ww,    Ww,    Wo,    Wo,    Ww,    Ww,    Ww,    Gg,    Gg,    Gg,    Gg,    Gg,    Gs^Fp,    Gs^Fp,    Gg,    Gg,    Gg,    Gg,    Gg,    Gg,    Gg,    Gg,    Gg,    Gg,    Gg,    Gg,    Gg,    Gg,    Gg,    Gg,    Gg,    Gg,    Gg,    Gg,    Gg
    Gg,    Gg,    Gg,    Gg,    Gg,    Gg,    Gg,    Gg,    Gg,    Gg,   Gg^Ve,    Gg,    Gg,    Gg,    Gg,    Ww,    Ww,    Ww,    Ww,    Ww,    Ww,    Wo,    Ww,    Ww,    Gg,    Gg,    Gg,    Gg,    Gs^Fp,    Gs^Fp,    Gs^Fp,    Gs^Fp,    Gs^Fp,    Gg,    Gs^Fp,    Gs^Fp,    Gs^Fp,    Gg,    Gg,    Gg,    Gg,    Gg,    Gg,    Gg,    Gg,    Gg,    Gg,    Gg,    Gg,    Gg,    Gg,    Gg
    Gg,    Gg,    Gg,    Gg,    Gg,    Gg,    Gg,    Gg,    Gg,    Gg,    Gg,    Gg,    Gg,    Gg,    Gg,    Ww,    Gs^Fp,    Gs^Fp,    Gs^Fp,    Ww,    Gs^Fp,    Wo,    Wo,    Ww,    Ww,    Ww,    Ww,    Gs^Fp,    Gs^Fp,    Gs^Fp,    Gs^Fp,    Gs^Fp,    Gs^Fp,    Gs^Fp,    Gs^Fp,    Gs^Fp,    Gs^Fp,    Gs^Fp,    Gg,    Gg,    Gg,    Gg,    Gg,    Gg,    Gg,    Gg,    Gg,    Gg,    Gg,    Gg,    Gg,    Gg
    Gg,    Gg,    Gg,    Gg,    Gg,    Gg,    Gg,    Gg,    Gg,    Gg,    Gg,    Gg,    Gg,    Gg,    Gg,    Gg,    Gs^Fp,    Gs^Fp,    Gs^Fp,    Ww,    Gs^Fp,    Wo,    Wo,    Wo,    Wo,    Ww,    Ww,    Gs^Fp,    Gs^Fp,    Gs^Fp,    Gs^Fp,    Gs^Fp,    Gs^Fp,    Gs^Fp,    Gs^Fp,    Gs^Fp,    Gs^Fp,    Gs^Fp,    Gs^Fp,    Gg,    Gg,    Gg,    Gg,    Gg,    Gg,    Gg,    Gg,    Gg,    Gg,    Gg,    Gg,    Gg
    Gg,    Gg,    Gg,    Gg,    Gg,    Gg,    Gg,    Gg,    Gg,    Gg,    Gg,    Gg,    Gg,    Gg,    Gg,    Gg,    Gg,    Gs^Fp,    Gs^Fp,    Gs^Fp,    Gs^Fp,    Gs^Fp,    Gs^Fp,    Ww,    Gs^Fp,    Wo,    Wo,    Ww,    Ww,    Ww,    Ww,    Gs^Fp,    Gs^Fp,    Gs^Fp,    Gs^Fp,    Gs^Fp,    Gs^Fp,    Gs^Fp,    Gs^Fp,    Gs^Fp,    Gg,    Gg,    Gg,    Gg,    Gg,    Gg,    Gg,   Gg^Ve,    Gg,    Gg,    Gg,    Gg
    Gg,    Gg,    Gg,    Gg,    Gg,    Gg,    Gg,    Gg,    Gg,    Gg,    Gg,    Gg,    Gg,    Gg,    Gg,    Gg,    Gs^Fp,    Gs^Fp,    Gs^Fp,    Gs^Fp,    Gs^Fp,    Gs^Fp,    Gs^Fp,    Gs^Fp,    Gs^Fp,    Ww,    Ww,    Wo,    Wo,    Ww,    Ww,    Ww,    Ww,    Gs^Fp,    Gs^Fp,   Gg^Vh,    Gs^Fp,    Gs^Fp,    Gs^Fp,    Gg,    Gg,    Gg,    Gg,    Gg,    Gg,    Gg,    Gg,    Gg,    Gg,    Gg,    Gg,    Gg
    Gg,    Gg,    Gg,    Gg,    Gg,    Gg,    Gg,    Gg,    Gg,    Gg,    Gg,    Gg,    Gg,    Gg,    Gg,    Gs^Fp,    Gs^Fp,    Gs^Fp,    Gs^Fp,    Gs^Fp,    Gs^Fp,    Gs^Fp,    Gs^Fp,    Gs^Fp,    Gs^Fp,    Gs^Fp,    Gs^Fp,    Ww,    Wo,   Ww^Vm,    Wo,    Ww,    Ww,    Gs^Fp,    Gs^Fp,    Gs^Fp,    Gs^Fp,    Gs^Fp,    Gs^Fp,    Gg,    Gg,    Gg,    Gg,   Gg^Vh,    Gg,    Gg,    Gg,    Gg,    Gg,    Gg,    Gg,    Gg
    Gg,    Gg,    Gg,    Gg,    Gg,    Gg,    Gg,    Gg,    Gg,    Gg,    Gg,    Gg,    Gg,    Gg,    Gg,    Gs^Fp,    Gs^Fp,    Gs^Fp,    Gs^Fp,    Gs^Fp,    Gs^Fp,    Gs^Fp,    Gs^Fp,    Gs^Fp,    Gs^Fp,    Gs^Fp,    Gs^Fp,    Ww,    Gs^Fp,    Wo,    Ww,    Wo,    Wo,    Ww,    Gs^Fp,    Gs^Fp,    Gs^Fp,    Gs^Fp,    Gs^Fp,    Gs^Fp,    Gs^Fp,    Gg,    Gg,    Gg,    Gg,    Gg,    Gg,    Gg,    Gg,    Gg,    Gg,    Gg
    Gg,    Gg,    Gg,    Gg,    Gg,    Gg,    Gg,    Gg,    Gg,    Gg,    Gg,    Gg,    Gg,    Gg,    Gg,    Gg,    Gg,    Gs^Fp,    Gs^Fp,    Gs^Fp,    Gs^Fp,    Gs^Fp,    Gs^Fp,    Gs^Fp,    Gs^Fp,    Gs^Fp,    Gs^Fp,    Gs^Fp,    Gs^Fp,    Ww,    Ww,    Ww,    Ww,    Wo,    Wo,    Gs^Fp,    Gs^Fp,    Gs^Fp,    Gs^Fp,    Gs^Fp,    Gs^Fp,    Gg,    Gg,    Gg,    Gg,    Gg,    Gg,    Gg,    Gg,    Gg,    Gg,    Gg
    Gg,    Gg,    Gg,    Gg,    Gg,    Gg,   Gg^Vh,    Gg,    Gg,    Gg,    Gg,    Gg,    Gg,    Gg,    Gg,    Gg,    Gs^Fp,    Gs^Fp,    Gs^Fp,    Gs^Fp,    Gs^Fp,    Gs^Fp,   Gg^Ve,    Gs^Fp,    Gs^Fp,    Gs^Fp,    Gs^Fp,    Gs^Fp,    Gs^Fp,    Gs^Fp,    Gs^Fp,    Ww,    Gs^Fp,    Wo,    Wo,    Ww,    Ww,    Gs^Fp,    Gs^Fp,    Gs^Fp,    Gs^Fp,    Gs^Fp,    Ww,    Gg,    Gg,    Gg,    Gg,    Gg,    Gg,    Gg,    Gg,    Gg
    Gg,    Gg,    Gg,    Gg,    Gg,    Gg,    Gg,    Gg,    Gg,    Gg,    Gg,    Gg,    Gg,    Gg,    Gg,    Gg,    Gg,    Gs^Fp,    Gs^Fp,    Gs^Fp,    Gs^Fp,    Gs^Fp,    Gs^Fp,    Gs^Fp,    Gs^Fp,    Gs^Fp,    Gs^Fp,    Gs^Fp,    Gs^Fp,    Gs^Fp,    Gs^Fp,    Gs^Fp,    Gs^Fp,    Ww,    Ww,    Wo,    Wo,    Ww,    Ww,    Gs^Fp,    Ww,    Ww,    Ww,    Ww,    Ce,    Gg,    Gg,    Gg,    Gg,    Gg,    Gg,    Gg
    Gg,    Gg,    Gg,    Gg,    Gg,    Gg,    Gg,    Gg,    Gg,    Gg,    Gg,    Gg,    Gg,    Gg,    Gg,    Gg,    Gg,    Gs^Fp,    Gs^Fp,    Gs^Fp,    Gs^Fp,    Gs^Fp,    Gs^Fp,    Gs^Fp,    Gs^Fp,    Gs^Fp,    Gs^Fp,    Gs^Fp,    Gs^Fp,    Gs^Fp,    Gs^Fp,    Gs^Fp,    Gs^Fp,    Gs^Fp,    Gs^Fp,    Ww,    Ww,    Wo,    Wo,    Ww,    Ww,    Ww,    Ww,    Ww,  Ww^Bw|,    Gg,    Gg,    Gg,    Gg,    Gg,    Gg,    Gg
    Gg,    Gg,    Gg,    Gg,    Gg,    Gg,    Gg,    Gg,   Gg^Ve,    Gg,    Gg,    Gg,    Gg,    Gg,    Gg,    Gg,    Gg,    Gg,    Gg,    Gs^Fp,    Gs^Fp,    Gs^Fp,    Gs^Fp,    Gs^Fp,    Gs^Fp,    Gs^Fp,    Gs^Fp,    Gs^Fp,    Gs^Fp,    Gs^Fp,    Gs^Fp,    Gs^Fp,    Gs^Fp,    Gs^Fp,    Gs^Fp,    Gs^Fp,    Gs^Fp,    Wo,    Ww,    Wo,    Wo,    Ww,    Wo,    Ww,  Ww^Bw|,    Ww,    Gg,    Gg,    Gg,    Gg,    Gg,    Gg
    Gg,    Gg,    Gg,    Gg,    Gg,    Gg,    Gg,    Gg,    Gg,    Gg,    Gg,    Gg,    Gg,    Gg,    Gg,    Gg,    Hh,    Gg,    Hh,    Gs^Fp,    Gs^Fp,    Gs^Fp,    Gs^Fp,    Gs^Fp,    Gs^Fp,    Gs^Fp,    Gs^Fp,    Gs^Fp,    Gs^Fp,    Gs^Fp,    Gs^Fp,    Gs^Fp,    Gs^Fp,    Gs^Fp,    Gs^Fp,    Gs^Fp,    Gs^Fp,    Ww,    Ww,    Ww,    Ww,    Wo,    Wo,    Ww,  Ww^Bw|,    Ww,    Ww,    Gg,    Gg,    Gg,    Gg,    Gg
    Gg,    Gg,    Gg,    Gg,    Gg,    Gg,    Gg,    Gg,    Gg,    Gg,    Hh,    Gg,    Hh,    Gg,    Hh,    Hh,    Hh,    Hh,    Gg,    Hh,    Gg,    Gg,    Gs^Fp,    Gs^Fp,    Gs^Fp,    Gs^Fp,    Gs^Fp,    Gs^Fp,    Gs^Fp,    Gs^Fp,    Gs^Fp,    Gs^Fp,    Gs^Fp,    Gs^Fp,    Gs^Fp,    Gs^Fp,    Gg,    Gg,    Ww,    Ww,    Ww,    Ww,    Ww,    Wo,  Ww^Bw|,    Wo,    Ww,    Ww,    Ww,    Gg,    Ww,    Ww
    Gg,    Gg,    Gg,    Gg,    Gg,    Gg,    Gg,    Gg,    Gg,    Gg,    Hh,    Hh,    Mm,    Hh,    Mm,    Hh,    Mm,    Hh,    Hh,    Gg,    Gg,    Gg,    Gg,    Gs^Fp,    Gg,    Gs^Fp,    Gg,    Gg,    Gs^Fp,    Gg,    Gg,    Gs^Fp,    Gs^Fp,    Gs^Fp,    Gg,    Gs^Fp,    Gg,    Gg,    Gg,    Ww,    Ww,   Ww^Vm,    Ww,    Ww,  Ww^Bw|,    Wo,    Wo,    Ww,    Wo,    Ww,    Ww,    Ww
    Gg,    Gg,    Gg,    Gg,    Gg,    Gg,    Gg,    Gg,    Gg,    Hh,    Hh,    Mm,    Mm,    Mm,    Mm,    Mm,    Mm,    Hh,    Hh,    Gg,    Gg,    Gg,    Gg,    Gg,    Gg,    Gg,    Gg,    Gg,    Gg,    Gg,    Gg,    Gg,    Gg,    Gg,    Gg,    Gg,    Gg,    Gg,    Gg,    Gg,    Ww,    Ww,    Ww,    Ww,  Ww^Bw|,    Ww,    Ww,    Wo,    Ww,    Wo,    Wo,    Wo
    Gg,    Gg,    Gg,    Gg,    Gg,    Gg,    Gg,    Gg,    Hh,    Hh,    Mm,    Mm,    Mm,    Mm,    Mm,    Mm,    Hh,    Hh,    Hh,    Gg,    Gg,    Gg,    Gg,    Gg,    Gg,    Gg,    Gg,    Gg,    Gg,    Gg,    Gg,    Gg,    Gg,    Gg,    Gg,    Gg,    Gg,    Gg,    Gg,    Gg,    Gg,    Ww,    Ww,    Ww,  Ww^Bw|,    Ww,    Ww,   Ww^Vm,    Ww,    Ww,    Ww,    Ww
    Gg,    Gg,    Gg,    Gg,    Gg,    Gg,    Gg,    Hh,    Hh,    Mm,    Mm,    Mm,    Mm,    Mm,    Hh,    Mm,    Hh,    Hh,    Gg,    Gg,    Gg,    Gg,    Gg,    Gg,    Gg,    Gg,    Gg,    Gg,    Gg,    Gg,    Gg,    Gg,    Gg,    Gg,    Gg,    Gg,    Gg,    Gg,    Gg,    Gg,    Gg,    Gg,    Gg,    Ww,    Ce,    Ww,    Ww,    Ww,    Ww,    Ww,    Ww,    Ww
    Gg,    Gg,    Gg,    Gg,    Gg,    Hh,    Hh,    Hh,    Mm,    Mm,    Hh,    Hh,    Hh,    Hh,    Gg,    Hh,    Gg,    Gg,    Gg,    Gg,    Gg,    Gg,    Gg,    Gg,    Gg,    Gg,    Gg,   Gg^Ve,    Gg,    Gg,    Gg,    Gg,    Gg,    Gg,    Gg,    Gg,    Gg,    Gg,    Gg,    Gg,    Gg,    Gg,    Gg,    Gg,    Gg,    Gg,    Gg,    Ww,    Gg,    Ww,    Gg,    Gg
    Gg,    Gg,    Gg,    Gg,    Gg,    Hh,    Hh,    Mm,    Hh,    Mm,    Gg,    Gg,   Chr,   Chr,   Chr,    Gg,    Gg,    Gg,    Gg,    Gg,    Gg,    Gg,    Gg,    Gg,    Gg,    Gg,    Gg,    Gg,    Gg,    Gg,    Gg,    Gg,   Gg^Vh,    Gg,    Gg,    Gg,    Gg,    Gg,    Ce,    Ce,    Ce,    Gg,    Gg,    Gg,    Gg,    Gg,    Gg,    Gg,    Gg,    Gg,    Gg,    Gg
    Gg,    Gg,    Gg,    Gg,    Gg,    Gg,    Hh,    Hh,    Hh,    Hh,    Gg,    Gg,   Chr,  2 Khr,   Chr,    Gg,    Gg,    Gg,    Gg,    Gg,    Gg,    Gg,    Gg,    Gg,    Gg,    Gg,    Gg,    Gg,    Gg,    Gg,    Gg,    Gg,    Gg,    Gg,    Gg,    Gg,    Gg,    Gg,    Ce,  1 Ke,    Ce,    Gg,    Gg,    Gg,    Gg,    Gg,    Gg,    Gg,    Gg,    Gg,    Gg,    Gg
    Gg,    Gg,    Gg,    Gg,    Gg,    Gg,    Gg,    Hh,    Hh,    Gg,    Gg,    Gg,    Gg,   Chr,    Gg,    Gg,    Gg,    Gg,    Gg,    Gg,    Gg,    Gg,    Gg,    Gg,    Gg,    Gg,    Gg,    Gg,    Gg,    Gg,    Gg,    Gg,    Gg,    Gg,    Gg,    Gg,    Gg,    Gg,    Gg,    Ce,    Gg,    Gg,    Gg,    Gg,    Gg,    Gg,    Gg,    Gg,    Gg,    Gg,    Gg,    Gg
    Gg,    Gg,    Gg,    Gg,    Gg,    Gg,    Hh,    Hh,    Hh,    Hh,    Gg,    Gg,    Gg,    Gg,    Gg,    Gg,    Gg,    Gg,    Gg,    Gg,    Gg,    Gg,    Gg,    Gg,    Gg,    Gg,    Gg,    Gg,    Gg,    Gg,    Gg,    Gg,    Gg,    Gg,    Gg,    Gg,    Gg,    Gg,    Gg,    Gg,    Gg,    Gg,    Gg,    Gg,    Gg,    Gg,    Gg,    Gg,    Gg,    Gg,    Gg,    Gg
    Gg,    Gg,    Gg,    Gg,    Gg,    Gg,    Hh,    Hh,    Hh,    Hh,    Gg,    Gg,    Gg,    Gg,    Gg,    Gg,    Gg,    Gg,    Gg,    Gg,    Gg,    Gg,    Gg,    Gg,    Gg,    Gg,    Gg,    Gg,    Gg,    Gg,    Gg,    Gg,    Gg,    Gg,    Gg,    Gg,    Gg,    Gg,    Gg,    Gg,    Gg,    Gg,    Gg,    Gg,    Gg,    Gg,    Gg,    Gg,    Gg,    Gg,    Gg,    Gg
    Gg,    Gg,    Gg,    Gg,    Gg,    Gg,    Hh,    Hh,    Hh,    Hh,    Gg,    Gg,    Gg,    Gg,    Gg,    Gg,    Gg,    Gg,    Gg,    Gg,    Gg,    Gg,    Gg,    Gg,    Gg,    Gg,    Gg,    Gg,    Gg,    Gg,    Gg,    Gg,    Gg,    Gg,    Gg,    Gg,    Gg,    Gg,    Gg,    Gg,    Gg,    Gg,    Gg,    Gg,    Gg,    Gg,    Gg,    Gg,    Gg,    Gg,    Gg,    Gg
