border_size=1
usage=map

Yww         , Yww         , Yww         , Yww         , Yww         , Yww         , Yww         , Yww         , Yww         , Yww         , Yww         , Yww         , Yww         , Yww         , Yww         , Yww         , Yww         , Yww         , Yww         , Yww         , Yww         , Yww         
Yww         , Yww         , Yww         , Yww         , Yww         , Yww         , Yww         , Yww         , Yww         , Yww         , Yww         , Yww         , Yww         , Yww         , Yww         , Yww         , Yww         , Yww         , Yww         , Yww         , Yww         , Yww         
Yww         , Yww         , Yww         , Yww         , Yww         , Yww         , Yww         , Yww         , Yww         , Yww         , Yww         , Yww         , Yww         , Yww         , Yww         , Yww         , Yww         , Yww         , Yww         , Yww         , Yww         , Yww         
Yww         , Yww         , Yww         , Yww         , Yww         , Yww         , Yww         , Yww         , Yww         , Yww         , Yww         , Yww         , Yww         , Yww         , Yww         , Yww         , Yww         , Yww         , Yww         , Yww         , Yww         , Yww         
Yww         , Yww         , Yww         , Yww         , Yww         , Yww         , Yww         , Yww         , Yww         , Yww         , Yww         , Yww         , Yww         , Yww         , Yww         , Yww         , Yww         , Yww         , Yww         , Yww         , Yww         , Yww         
Yww         , Yww         , Yww         , Yww         , Yww         , Yww         , Yww         , Yww         , Yww         , Yww         , Yww         , Yww         , Yww         , Yww         , Yww         , Yww         , Yww         , Yww         , Yww         , Yww         , Yww         , Yww         
Yww         , Yww         , Yww         , Yww         , Yww         , Yww         , Yww         , Yww         , Yww         , Yww         , Yww         , Yww         , Yww         , Yww         , Yww         , Yww         , Yww         , Yww         , Yww         , Yww         , Yww         , Yww         
Yww         , Yww         , Yww         , Yww         , Yww         , Yww         , Yww         , Yww         , Yww         , Yww         , Yww         , Yww         , Yww         , Yww         , Yww         , Yww         , Yww         , Yww         , Yww         , Yww         , Yww         , Yww         
Yww         , Yww         , Yww         , Yww         , Yww         , Yww         , Yww         , Yww         , Yww         , Yww         , Yww         , Yww         , Yww         , Yww         , Yww         , Yww         , Yww         , Yww         , Yww         , Yww         , Yww         , Yww         
Yww         , Yww         , Yww         , Yww         , Yww         , Yww         , Yww         , Yww         , Yf          , 1 Kh        , Yf          , Yww         , Yww         , Yww         , Yww         , Yww         , Yww         , Yww         , Yww         , Yww         , Yww         , Yww         
Yww         , Yww         , Yww         , Yww         , Yww         , Yww         , Yww         , Yww         , Yf          , Yf          , Yf          , Yww         , Yww         , Yww         , Yww         , Yww         , Yww         , Yww         , Yww         , Yww         , Yww         , Yww         
Yww         , Yww         , Yww         , Yww         , Yww         , Yww         , Yww         , Yww         , Yf          , Yf          , Yf          , Yww         , Yww         , Yww         , Yww         , Yww         , Yww         , Yww         , Yww         , Yww         , Yww         , Yww         
Yww         , Yww         , Yww         , Yww         , Yww         , Yww         , Yww         , Yww         , Yf          , Yf          , Yf          , Yww         , Yww         , Yww         , Yww         , Yww         , Yww         , Yww         , Yww         , Yww         , Yww         , Yww         
Yww         , Yww         , Yww         , Yww         , Yww         , Yww         , Yww         , Yww         , Yf          , Yf          , Yf          , Yww         , Yww         , Yww         , Yww         , Yww         , Yww         , Yww         , Yww         , Yww         , Yww         , Yww         
Yww         , Yww         , Yww         , Yww         , Yww         , Yww         , Yww         , Yww         , Yf          , Yf          , Yf          , Yww         , Yww         , Yww         , Yww         , Yww         , Yww         , Yww         , Yww         , Yww         , Yww         , Yww         
Yww         , Yww         , Yww         , Yww         , Yww         , Yww         , Yww         , Yww         , Yf          , Yf          , Yf          , Yww         , Yww         , Yww         , Yww         , Yww         , Yww         , Yww         , Yww         , Yww         , Yww         , Yww         
Yww         , Yww         , Yww         , Yww         , Yww         , Yww         , Yww         , Yww         , Yf          , Yf          , Yf          , Yww         , Yww         , Yww         , Yww         , Yww         , Yww         , Yww         , Yww         , Yww         , Yww         , Yww         
Yww         , Yww         , Yww         , Yww         , Yww         , Yww         , Yww         , Yww         , Yf          , Yf          , Yf          , Yww         , Yww         , Yww         , Yww         , Yww         , Yww         , Yww         , Yww         , Yww         , Yww         , Yww         
Yww         , Yww         , Yww         , Yww         , Yww         , Yww         , Yww         , Yww         , Yf          , Yf          , Yf          , Yww         , Yww         , Yww         , Yww         , Yww         , Yww         , Yww         , Yww         , Yww         , Yww         , Yww         
Yww         , Yww         , Yww         , Yww         , Yww         , Yww         , Yww         , Yww         , Yf          , Yf          , Yf          , Yww         , Yww         , Yww         , Yww         , Yww         , Yww         , Yww         , Yww         , Yww         , Yww         , Yww         
Yww         , Yww         , Yww         , Yww         , Yww         , Yww         , Yww         , Yww         , Yf          , Yf          , Yf          , Yww         , Yww         , Yww         , Yww         , Yww         , Yww         , Yww         , Yww         , Yww         , Yww         , Yww         
Yww         , Yww         , Yww         , Yww         , Yww         , Yww         , Yww         , Yww         , Yf          , Yf          , Yf          , Yww         , Yww         , Yww         , Yww         , Yww         , Yww         , Yww         , Yww         , Yww         , Yww         , Yww         
Yww         , Yww         , Yww         , Yww         , Yww         , Yww         , Yww         , Yww         , Yf          , Yf          , Yf          , Yww         , Yww         , Yww         , Yww         , Yww         , Yww         , Yww         , Yww         , Yww         , Yww         , Yww         
Yww         , Yww         , Yww         , Yww         , Yww         , Yww         , Yww         , Yww         , Yf          , Yf          , Yf          , Yww         , Yww         , Yww         , Yww         , Yww         , Yww         , Yww         , Yww         , Yww         , Yww         , Yww         
Yww         , Yww         , Yww         , Yww         , Yww         , Yww         , Yww         , Yww         , Yf          , Yf          , Yf          , Yww         , Yww         , Yww         , Yww         , Yww         , Yww         , Yww         , Yww         , Yww         , Yww         , Yww         
Yww         , Yww         , Yww         , Yww         , Yww         , Yww         , Yww         , Yww         , Yf          , Yf          , Yf          , Yww         , Yww         , Yww         , Yww         , Yww         , Yww         , Yww         , Yww         , Yww         , Yww         , Yww         
Yww         , Yww         , Yww         , Yww         , Yww         , Yww         , Yww         , Yww         , Yf          , Yf          , Yf          , Yww         , Yww         , Yww         , Yww         , Yww         , Yww         , Yww         , Yww         , Yww         , Yww         , Yww         
Yww         , Yww         , Yww         , Yww         , Yww         , Yww         , Yww         , Yww         , Yf          , Yf          , Yf          , Yww         , Yww         , Yww         , Yww         , Yww         , Yww         , Yww         , Yww         , Yww         , Yww         , Yww         
Yww         , Yww         , Yww         , Yww         , Yww         , Yww         , Yww         , Yww         , Yf          , Yf          , Yf          , Yww         , Yww         , Yww         , Yww         , Yww         , Yww         , Yww         , Yww         , Yww         , Yww         , Yww         
Yww         , Yww         , Yww         , Yww         , Yww         , Yww         , Yww         , Yww         , Yf          , Yf          , Yf          , Yww         , Yww         , Yww         , Yww         , Yww         , Yww         , Yww         , Yww         , Yww         , Yww         , Yww         
Yww         , Yww         , Yww         , Yww         , Yww         , Yww         , Yww         , Yww         , Yf          , Yf          , Yf          , Yww         , Yww         , Yww         , Yww         , Yww         , Yww         , Yww         , Yww         , Yww         , Yww         , Yww         
Yww         , Yww         , Yww         , Yww         , Yww         , Yww         , Yww         , Yww         , Yf          , Yf          , Yf          , Yww         , Yww         , Yww         , Yww         , Yww         , Yww         , Yww         , Yww         , Yww         , Yww         , Yww         
