border_size=1
usage=map

    Gg,    Gg,    Gg,    Gg,    Gg,    Gg,    Gg,    Gg,    Gg,    Xu,    Uu,    Uu,    Uu,    Xu,    Gg,    Gg,    Gg,    Gg,    Gg,    Gg,    Gg,    Gg
    Gg,    Gg,    Gg,    Gg,    Gg,    Gg,    Gg,    Gg,    Gg,    Xu,    Uu,    Uu,    Uu,    Xu,    Gg,    Gg,    Gg,    Gg,    Gg,    Gg,    Gg,    Gg
    Gg,    Gg,    Gg,    Gg,    Gg,    Gg,    Gg,    Gg,    Gg,    Xu,    Uu,    Uu,    Uu,    Xu,    Gg,    Gg,    Gg,    Gg,    Gg,    Gg,    Gg,    Gg
    Gg,    Gg,    Gg,    Gg,    Gg,    Gg,    Gg,    Gg,    Gg,    Xu,    Uu,    Uu,    Uu,    Xu,    Gg,    Gg,    Gg,    Gg,    Gg,    Gg,    Gg,    Gg
    Gg,    Gg,    Gg,    Gg,    Gg,    Gg,    Gg,    Gg,    Gg,    Gg,    Gg,    Gg,    Gg,    Gg,    Gg,    Gg,    Gg,    Gg,    Gg,    Gg,    Gg,    Gg
    Gg,    Gg,    Gg,    Gg,    Gg,    Gg,    Gg,    Gg,    Gg,    Gg,    Gg,    Gg,    Gg,    Gg,    Gg,    Gg,    Gg,    Gg,    Gg,    Gg,    Gg,    Gg
    Gg,    Gg,    Gg,    Gg,    Gg,    Gg,   Gg^Ve,    Gg,   Gg^Ve,    Gg,    Gg,    Gg,    Gg,    Gg,   Gg^Ve,    Gg,   Gg^Ve,    Gg,    Gg,    Gg,    Gg,    Gg
    Gg,    Gg,    Gg,    Gg,    Gg,    Gg,   Gg^Ve,   Gg^Ve,    Gg,   Gg^Ve,    Gg,  1 Kh,    Gg,   Gg^Ve,    Gg,   Gg^Ve,   Gg^Ve,    Gg,    Gg,    Gg,    Gg,    Gg
    Gg,    Gg,    Gg,    Gg,    Gg,    Gg,   Gg^Ve,    Gg,    Gg,    Gg,    Ch,    Ch,    Ch,    Gg,    Gg,    Gg,   Gg^Ve,    Gg,    Gg,    Gg,    Gg,    Gg
    Gg,    Gg,    Gg,    Gg,    Gg,    Gg,   Gg^Ve,    Gg,    Gg,    Gg,    Gg,    Gg,    Gg,    Gg,    Gg,    Gg,   Gg^Ve,    Gg,    Gg,    Gg,    Gg,    Gg
    Gg,    Gg,    Gg,    Gg,    Gg,    Gg,    Gg,    Gg,    Gg,    Gg,    Gg,    Gg,    Gg,    Gg,    Gg,    Gg,    Gg,    Gg,    Gg,    Gg,    Gg,    Gg
    Gg,    Gg,    Gg,    Gg,    Gg,    Gg,    Hh,    Gg,    Gg,    Gg,    Gg,    Gg,    Gg,    Gg,    Gg,    Gg,    Gg,    Gg,    Hh,    Gg,    Gg,    Gg
    Gg,    Gg,    Gg,    Gg,    Hh,    Hh,    Hh,    Gg,    Hh,    Gg,    Gg,    Rr,    Rr,    Gg,    Gg,    Hh,    Gg,    Hh,    Hh,    Gg,    Gg,    Gg
    Hh,    Hh,    Hh,    Hh,    Hh,    Mm,    Hh,    Hh,    Hh,    Rr,    Rr,    Rr,    Hh,    Hh,    Hh,    Hh,    Hh,    Hh,    Mm,    Hh,    Hh,    Hh
    Mm,    Mm,    Hh,    Mm,    Mm,    Mm,    Mm,    Hh,    Mm,    Mm,    Rr,    Rr,    Rr,    Hh,    Mm,    Hh,    Hh,    Mm,    Mm,    Hh,    Mm,    Mm
    Mm,    Mm,    Mm,    Mm,    Mm,    Mm,    Mm,    Mm,    Mm,    Mm,    Mm,    Rr,    Mm,    Mm,    Mm,    Mm,    Mm,    Mm,    Mm,    Mm,    Mm,    Mm
    Mm,    Mm,    Mm,    Mm,    Mm,    Mm,    Mm,    Mm,    Mm,    Mm,    Mm,    Rr,    Mm,    Mm,    Mm,    Mm,    Mm,    Mm,    Mm,    Mm,    Mm,    Mm
    Mm,    Mm,    Mm,    Mm,    Mm,    Mm,    Mm,    Mm,    Mm,    Mm,    Mm,    Rr,    Mm,    Mm,    Mm,    Mm,    Mm,    Mm,    Mm,    Mm,    Mm,    Mm
    Mm,    Mm,    Mm,    Mm,    Mm,    Mm,    Mm,    Mm,    Mm,    Mm,    Mm,    Rr,    Mm,    Mm,    Mm,    Mm,    Mm,    Mm,    Mm,    Mm,    Mm,    Mm
    Mm,    Mm,    Mm,    Mm,    Mm,    Mm,    Mm,    Mm,    Mm,    Mm,    Mm,    Rr,    Mm,    Mm,    Mm,    Mm,    Mm,    Mm,    Mm,    Mm,    Mm,    Mm
    Mm,    Mm,    Mm,    Mm,    Mm,    Mm,    Mm,    Mm,    Mm,    Mm,    Mm,    Rr,    Mm,    Mm,    Mm,    Mm,    Mm,    Mm,    Mm,    Mm,    Mm,    Mm
    Mm,    Mm,    Mm,    Mm,    Mm,    Mm,    Mm,    Mm,    Mm,    Mm,    Mm,    Rr,    Mm,    Mm,    Mm,    Mm,    Mm,    Mm,    Mm,    Mm,    Mm,    Mm
    Mm,    Mm,    Hh,    Mm,    Mm,    Mm,    Mm,    Hh,    Mm,    Mm,    Rr,    Rr,    Rr,    Hh,    Mm,    Hh,    Hh,    Mm,    Mm,    Hh,    Mm,    Mm
    Hh,    Hh,    Hh,    Hh,    Hh,    Mm,    Hh,    Hh,    Hh,    Rr,    Rr,    Rr,    Hh,    Hh,    Hh,    Hh,    Hh,    Hh,    Mm,    Hh,    Hh,    Hh
    Gg,    Gg,    Gg,    Gg,    Hh,    Hh,    Hh,    Gg,    Hh,    Gg,    Gg,    Rr,    Rr,    Gg,    Gg,    Hh,    Gg,    Hh,    Hh,    Gg,    Gg,    Gg
    Gg,    Gg,    Gg,    Gg,    Gg,    Gg,    Hh,    Gg,    Gg,    Gg,    Gg,    Gg,    Gg,    Gg,    Gg,    Gg,    Gg,    Gg,    Hh,    Gg,    Gg,    Gg
    Gg,    Gg,    Gg,    Gg,    Gg,    Gg,    Gg,    Gg,    Gg,    Gg,    Gg,    Gg,    Gg,    Gg,    Gg,    Gg,    Gg,    Gg,    Gg,    Gg,    Gs^Fp,    Gs^Fp
    Gg,    Gg,    Gg,    Gg,    Gg,    Gg,   Gg^Ve,    Gg,    Gg,    Gg,    Gg,    Gg,    Gg,    Gg,    Gg,    Gg,   Gg^Ve,    Gg,    Gg,    Gs^Fp,    Gs^Fp,    Gs^Fp
    Gs^Fp,    Gs^Fp,    Gs^Fp,    Gg,    Gg,    Gg,   Gg^Ve,    Gg,    Gg,    Gg,    Ch,    Gg,    Ch,    Gg,    Gg,    Gg,   Gg^Ve,    Gg,    Gg,    Gg,    Gs^Fp,    Gs^Fp
    Gs^Fp,    Gs^Fp,    Gg,    Gg,    Gg,    Gg,   Gg^Ve,    Gg,    Gg,    Gg,    Gg,  2 Kh,    Gg,    Gg,    Gg,    Gg,   Gg^Ve,    Gg,    Gg,    Gg,    Gg,    Gg
    Gg,    Gg,    Gg,    Gg,    Gg,    Gg,   Gg^Ve,   Gg^Ve,   Gg^Ve,   Gg^Ve,    Gg,    Ch,    Gg,   Gg^Ve,   Gg^Ve,   Gg^Ve,   Gg^Ve,    Gg,    Gg,    Gg,    Gg,    Gg
    Gg,    Gg,    Gg,    Gg,    Gg,    Gg,    Gg,    Gg,    Gg,    Gg,    Gg,    Gg,    Gg,    Gg,    Gg,    Gg,    Gg,    Gg,    Gg,    Gg,    Gg,    Gg
    Mm,    Mm,    Mm,    Mm,    Mm,    Mm,    Mm,    Mm,    Mm,    Mm,    Mm,    Mm,    Mm,    Mm,    Mm,    Mm,    Mm,    Mm,    Mm,    Mm,    Mm,    Mm
    Mm,    Mm,    Mm,    Mm,    Mm,    Mm,    Mm,    Mm,    Mm,    Mm,    Mm,    Mm,    Mm,    Mm,    Mm,    Mm,    Mm,    Mm,    Mm,    Mm,    Mm,    Mm
    Mm,    Mm,    Mm,    Mm,    Mm,    Mm,    Mm,    Mm,    Mm,    Mm,    Mm,    Mm,    Mm,    Mm,    Mm,    Mm,    Mm,    Mm,    Mm,    Mm,    Mm,    Mm
    Mm,    Mm,    Mm,    Mm,    Mm,    Mm,    Mm,    Mm,    Mm,    Mm,    Mm,    Mm,    Mm,    Mm,    Mm,    Mm,    Mm,    Mm,    Mm,    Mm,    Mm,    Mm
    Mm,    Mm,    Mm,    Mm,    Mm,    Mm,    Mm,    Mm,    Mm,    Mm,    Mm,    Mm,    Mm,    Mm,    Mm,    Mm,    Mm,    Mm,    Mm,    Mm,    Mm,    Mm
