border_size=1
usage=map

Ss      ,Ss      , Ss          , Ww          , Ww          , Ww          , Ss          , Ss          , Ss         , Ss          , Ss          , Ss          , Ss          , Ss          , Ww          , Ss      , Wo          , Ss          , Ss          , Ss          , Wo          , Ss          , Ss          , Ss          , Ds          , Ss          , Ss          , Ss          , Ss          , Ss          , Ss          , Ww          , Ss          , Ss          , Ww          , Ss          , Ww          , Ww          , Ww          , Ww          , Ww          , Ww          
Ss      ,Ss^Vhs      , Ss          , Ww          , Ww          , Ww          , Ss          , Ss          , Chs         , Ss          , Ss          , Ss          , Ss          , Ss          , Ww          , Ss^Vhs      , Wo          , Ss          , Ss          , Ss          , Wo          , Ss          , Ss          , Ss          , Ds          , Ss          , Ss          , Ss          , Ss          , Ss          , Ss          , Ww          , Ss          , Ss          , Ww          , Ss          , Ww          , Ww          , Ww          , Ww          , Ww          , Ww          
Ss          ,Ss          , Ss          , Ww          , Ss          , Ss          , Ss          , Chs         , 1 Khs       , Chs         , Re          , Ss          , Re          , Ss          , Ww          , Ww          , Ss          , Ww          , Ww          , Ww          , Ww          , Ss          , Ww          , Ss          , Ss          , Ds          , Ss          , Gg          , Ss          , Ss          , Ww          , Ww          , Ds          , Ss          , Ww          , Ww          , Ww          , Ww          , Ww          , Ss          , Ww          , Ww          
Ss          ,Ss          , Ww          , Ss          , Ss          , Ss          , Ss          , Chs         , Chs         , Chs         , Ss          , Re          , Ss          , Re          , Ss^Bw\      , Ss          , Ss          , Ss          , Ss          , Ww          , Ww          , Ww          , Ss          , Ss^Bw/      , Ww          , Ss          , Ww          , Ds          , Ss          , Ss          , Ss^Bw\      , Ss          , Ss          , Ss          , Ss          , Ww          , Ss^Vhs      , Ww          , Ss          , Ss          , Ww          , Ww          
Ss          ,Ss          , Ss          , Ss          , Ww          , Ggf         , Ss          , Ss          , Ss^Bw|      , Ss          , Ww          , Ww          , Ww          , Ww          , Ss          , Re          , Re          , Ss          , Ss          , Ss          , Ss          , Re          , Re          , Ww          , Ww          , Ww          , Ww          , Ww          , Ww          , Ss          , Ww          , Re          , Re          , Ss          , Ss          , Ss          , Ss          , Ss          , Ww          , Ss          , Ss          , Ss          
Ss          ,Ss          , Ss          , Ww          , Ww          , Ww          , Ww          , Ww          , Ww^Bw|      , Ww          , Ww          , Ss          , Ss          , Ww          , Ss          , Ss          , Ss          , Re          , Ss          , Ss          , Ss          , Ss          , Re          , Ss          , Ss          , Ww          , Ww          , Ss          , Ss          , Ww          , Ss          , Ss          , Ggf         , Re          , Re          , Ss          , Ds          , Ds          , Ss          , Ss          , Ss          , Ss          
Ww          ,Ww          , Ww          , Ww          , Wo          , Wo          , Ww          , Ww          , Ss^Vhs      , Ww          , Ss          , Ss          , Ss          , Ss          , Ds          , Ss          , Ss          , Ss          , Re          , Ds          , Ds          , Ss          , Ss          , Ss          , Ss          , Ds          , Ss          , Ss          , Ss          , Ss          , Ds          , Ss          , Ss          , Ss          , Ss          , Ss          , Ss          , Ds          , Ss          , Ss          , Ss          , Ss          
Ww          ,Ww          , Ww          , Ww          , Ww          , Ww          , Ww^Bw/      , Ss          , Ss          , Ss          , Ds          , Ss          , Ds          , Ss          , Ss          , Ss          , Ss          , Ss          , Re          , Ss          , Ss          , Ss          , Ss          , Ss          , Ww          , Ss          , Ss          , Ss          , Ww          , Ss          , Ss          , Ss          , Ss          , Ss          , Re          , Re          , Ss          , Ss          , Ggf         , Ggf         , Ss          , Ss          
Ss          ,Ss          , Ww          , Ww          , Wo^Bw/      , Ww^Bw/      , Ww          , Ww          , Ss          , Ss          , Ww          , Ds          , Ss          , Ss          , Ss          , Ss          , Ww          , Ss          , Ss          , Ss^Vhs      , Ss          , Ss          , Ss          , Ss          , Ss          , Ss          , Ss          , Ww          , Ww          , Ss          , Ss          , Ss          , Ds          , Ss          , Ss          , Re          , Ss          , Ss          , Ss          , Ww          , Ww          , Ww          
Ss          ,Ss          , Ss          , Ss^Bw/      , Ww          , Ww          , Ss          , Ss          , Ww          , Ss          , Ww          , Ww          , Ss          , Ss          , Ss^Vhs      , Ss          , Ss          , Ss          , Ss          , Ss          , Ss          , Ss          , Re          , Ss          , Ss          , Ggf         , Ss          , Ww          , Ss          , Ww          , Ww          , Ss          , Ss          , Ss          , Ss          , Re          , Re          , Ss          , Ss          , Ww          , Ss          , Ss          
Ss          ,Ss          , Ss          , Ss          , Ww          , Ss          , Ss          , Ss          , Ss          , Ss          , Ww          , Ww          , Ww          , Ww          , Ww          , Ww          , Ss          , Ggf         , Ggf         , Ss          , Ss          , Ss          , Re          , Ss          , Ggf         , Ggf         , Ss          , Ww          , Ss          , Ss          , Ss          , Ww          , Ss^Vhs      , Ss          , Ss          , Ww          , Ss^Bw|      , Ww          , Ww          , Ww          , Ss          , Ss          
Ww          ,Ww          , Ww          , Ww          , Ww          , Ww          , Ss          , Ss          , Ss          , Ss          , Ww          , Ww          , Ss          , Ww          , Ss          , Ww          , Re          , Ss          , Re          , Ss          , Ss          , Ss          , Re          , Ss          , Re          , Ss          , Ss          , Ww          , Ss          , Ss          , Ss          , Ww          , Ww          , Ss          , Ww          , Ww          , Ss          , Ss          , Ss          , Ss          , Ss          , Ss          
Ww          ,Ww          , Wo          , Wo          , Ww          , Ww          , Ww          , Ww          , Ww          , Ww^Bw\      , Ss          , Ss          , Ss          , Ss          , Ss          , Ss^Bw/      , Ww          , Re          , Ss          , Re          , Ss          , Re          , Ss          , Re          , Ss          , Re          , Re          , Ww          , Ss          , Ss          , Ggf         , Ww          , Ww          , Ww          , Ss          , Ss          , Ss          , Ss          , Ss          , Ss          , Ss          , Ss          
Ww          ,Ww          , Ww          , Wo          , Ww          , Ww          , Ss          , Ss          , Ss          , Ww          , Ss          , Ss          , Ss          , Ss          , Ss          , Ss          , Ss^Vhs      , Ww          , Ss          , Ss          , Ss          , Ss          , Ds          , Ss          , Ss          , Ss          , Ww          , Ss^Bw\      , Re          , Ss          , Ggf         , Ss          , Ss          , Ss          , Ds          , Ds          , Ss          , Ss          , Ds          , Ss          , Ss          , Ss          
Ss          ,Ss          , Ww          , Ww          , Ww          , Ss          , Ss          , Ss          , Ss          , Ds          , Ss          , Ss          , Ss          , Ds          , Ds          , Ss          , Ss          , Ww          , Ww          , Ss          , Ss          , Ds          , Ss          , Ss          , Chs         , Ss^Vhs      , Ww          , Ss          , Ss          , Re          , Re          , Ss          , Ss          , Ss          , Ss          , Ss          , Ss          , Ds          , Ss          , Ss          , Ss          , Ss          
Ss          ,Ss          , Ss          , Ss^Vhs      , Ss          , Ss          , Ss          , Gg^Fet      , Ss          , Ds          , Ss          , Ss          , Ss          , Ss          , Ds          , Ss          , Ss          , Ss          , Ww          , Ss          , Ds          , Ds          , Ss          , Khs         , Chw         , Chw         , Ww          , Ss          , Ss          , Ss          , Ss          , Re          , Re          , Ss          , Ss          , Ggf         , Ggf         , Ss          , Ss          , Ss          , Ss          , Ss          
Ss          ,Ss          , Ss          , Ss          , Ss          , Ds          , Ss          , Ss          , Ds          , Ss          , Ss          , Ss          , Ss          , Ggf         , Ss          , Ds          , Ss          , Ss          , Ww          , Ss          , Ss          , Ss          , Ss          , Chs         , Chw         , Khs         , Ss          , Ds          , Ss          , Ss          , Ss          , Gg^Fet      , Ss          , Re          , Ss          , Ggf         , Ss          , Ss          , Ss          , Ss          , Ss          , Ss          
Ss          ,Ss          , Ss          , Ds          , Ss          , Ss          , Ss          , Ww          , Ss          , Ss          , Ss          , Ss          , Ggf         , Ggf         , Ss          , Ss          , Ss          , Ss          , Ww          , Ww          , Ww          , Ss          , Ww          , Ww          , Ww          , Ss          , Ss          , Ss          , Ss          , Ss          , Ss          , Ss          , Ww          , Ww          , Ss          , Ss          , Ss          , Ss^Vhs      , Ss          , Ss          , Ss          , Ss          
Ss          ,Ss          , Ss          , Ds          , Ss          , Ss          , Ss          , Ss          , Ss          , Ss          , Ss          , Ggf         , Ss          , Ss          , Ss          , Ss          , Ds          , Ss          , Ss          , Ss          , Ww          , Ss          , Ww          , Ww          , Ss          , Ggf         , Ss          , Ss          , Ds          , Ds          , Ss          , Ss          , Ww          , Ww          , Ss          , Ss          , Ss          , Ss          , Ss          , Ss          , Ss          , Ss          
Re          ,Re          , Re          , Ss          , Ss          , Ss          , Ss          , Ds          , Ds          , Ss          , Ss          , Ss          , Ww          , Ss          , Ss          , Ds          , Ss          , Ds          , Ss          , Ss          , Ww          , Ss          , Wo^Bw\      , Ss          , Ss          , Ss          , Ss          , Ss          , Ss          , Ss          , Ss          , Ss          , Wo          , Wo          , Ss          , Ss          , Ss          , Ss          , Ds          , Ds          , Ss          , Ss          
Ss          ,Ss          , Re          , Ss          , Ss          , Ww          , Ss          , Ss          , Ss          , Ss          , Ss          , Ss          , Ss          , Ss          , Ss          , Ss          , Ss          , Ss          , Ss          , Ss          , Ss          , Ww          , Ww          , Ss          , Re          , Re          , Ss          , Ss          , Ss          , Ss          , Ww          , Ww          , Ss          , Ww          , Ss^Bw/      , Ss          , Gg          , Ss          , Ss          , Ss          , Ss          , Ss          
Ss          ,Ss          , Re          , Ss          , Ss          , Ss          , Ss          , Ss          , Ss          , Ww          , Ss^Vhs      , Ww          , Ss          , Ss          , Ww          , Ss^Bw|      , Ww          , Ww          , Ww          , Ww          , Ww          , Ww          , Ww          , Ss          , Ss          , Re          , Re          , Ss          , Ss^Vhs      , Ww          , Ss          , Ww          , Ss          , Ss          , Ww          , Ss          , Ww          , Ss          , Ss          , Ss          , Ss          , Ss          
Ss          ,Ss          , Re          , Ss          , Ss          , Ggf         , Ss          , Ww          , Ww          , Ww          , Ww          , Ww          , Ww          , Ww          , Ss          , Ss^Vhs      , Ww          , Ww          , Ss          , Ww          , Ss          , Ss          , Ww          , Ww          , Ss          , Ss          , Re          , Ss          , Ss^Bw\      , Ww          , Ss          , Ss          , Ss          , Ss          , Ss          , Ww          , Ss          , Ww          , Ww          , Ss          , Ww          , Ww          
Ss          ,Ss          , Re          , Ss^Vhs      , Ss          , Ggf         , Ss          , Ww          , Ww          , Ww          , Ww          , Ww          , Wo          , Ww          , Ss          , Ss          , Ss          , Ss          , Ss          , Ss          , Ss          , Ss          , Ss          , Ww          , Ww          , Ss          , Ss          , Ss          , Ww          , Ss          , Re          , Ss          , Ss          , Ss          , Ss          , Ss          , Ss          , Ww          , Ss          , Ww          , Ss          , Ss          
Ss          ,Ss          , Ss          , Re          , Re          , Ss          , Ss          , Ww          , Ww          , Ww^Vm       , Ww          , Ww          , Ss          , Ss          , Ds          , Ss          , Ss          , Ss          , Ss          , Dd          , Ss          , Ss          , Ss          , Ss          , Ss          , Ww          , Wwf         , Wwf         , Wwf         , Ss          , Re          , Re          , Ss^Vhs      , Ss          , Ds          , Ss          , Ss          , Ss          , Ss          , Ss^Vhs      , Ss          , Ss          
Ss          ,Ss          , Gg          , Ss          , Re          , Ss          , Ds          , Ss          , Ss          , Ww          , Ww          , Ww          , Ss          , Ss          , Ss          , Ds          , Ss          , Ss          , Ss          , Ss          , Ss          , Ss          , Ss          , Gg^Fet      , Ss          , Wwf         , Ss          , Wwf         , Wwf         , Ss          , Ss          , Re          , Ss          , Ss          , Ss          , Ds          , Ds          , Ds          , Ss          , Ss          , Ss          , Ss          
Ss          ,Ss          , Gg          , Ss          , Re          , Ss          , Ss          , Ss          , Ss          , Ss          , Ss          , Ss          , Ss          , Ss          , Ss          , Ss          , Ds          , Ss          , Ss          , Ss          , Ds          , Ss          , Ss          , Ss          , Ss          , Ss          , Ss          , Ss          , Ss          , Ss          , Ss          , Re          , Ss          , Ss          , Ss          , Ss          , Ss          , Ss          , Ss          , Ss          , Ss          , Ss          
Ss          ,Ss          , Ss          , Ss          , Re          , Ss          , Ss          , Gg^Fet      , Ss          , Ss          , Ds          , Ss          , Ss          , Ggf         , Ggf         , Ss          , Ss          , Ss          , Ss          , Ds          , Ss          , Ss          , Ds          , Ss          , Ss          , Ss          , Ss          , Ggf         , Ggf         , Ss          , Ss          , Re          , Ss          , Ss          , Ss          , Ss          , Ch          , Ss          , Ss          , Ss          , Ss          , Ss          
Ss          ,Ss          , Gg          , Ss          , Ss^Vhs      , Re          , Re          , Ss          , Re          , Ss          , Ss          , Ss          , Ss          , Ss          , Ss          , Ss          , Ss          , Ds          , Ds          , Ss          , Ss          , Ss          , Ss          , Ds          , Ss          , Ss          , Ss          , Ss          , Ss          , Ss          , Ss          , Ss          , Ss          , Ss          , Ss          , Ch          , 2 Kh        , Ch          , Ss          , Ss          , Ss          , Ss          
Ss          ,Ss          , Gg          , Ss          , Ss          , Ss          , Ss          , Re          , Ss          , Re          , Re          , Ss          , Ss^Vhs      , Ss          , Re          , Ss          , Ss          , Ss          , Ss          , Ss          , Ggf         , Ss          , Ggf         , Ss          , Ss          , Ds          , Ss          , Ds          , Ds          , Ss          , Ss          , Ss          , Ss          , Ss          , Ss          , Ch          , Ch          , Ch          , Ss          , Ss          , Ss          , Ss          
Ss          ,Ss          , Ss          , Ss          , Ggf         , Ggf         , Ggf         , Ss          , Ss          , Ss          , Ss          , Re          , Re          , Re          , Ss          , Re          , Re          , Ss          , Ss          , Ggf         , Ss          , Gg          , Ss          , Ss          , Ss          , Ss          , Ss          , Ds          , Ss          , Ss          , Ss          , Ss          , Ss^Vhs      , Ss          , Ss          , Ss          , Ss          , Ss          , Ss          , Ss          , Ss          , Ss          
Ss          ,Ss          , Ds          , Ss          , Ss          , Ss          , Ss          , Ss          , Ggf         , Ss          , Ss          , Ss          , Ss          , Ss          , Ss          , Ss          , Ss          , Re          , Re          , Ss          , Ss^Vhs      , Ss          , Ss          , Ss          , Ss          , Ss          , Ss          , Ss          , Ss          , Ss          , Ss          , Ss          , Ss          , Ss          , Ds          , Ss          , Ss          , Ss          , Ss          , Ss          , Ss          , Ss          
Ss          ,Ss          , Ds          , Ss          , Ss          , Ww          , Ss          , Ss          , Ss          , Ss          , Ss          , Ds          , Ds          , Ss          , Ss          , Ss          , Ds          , Ss          , Ss          , Re          , Re          , Re          , Re          , Ss          , Ss          , Ss          , Ss          , Ss          , Ds          , Ss          , Ss          , Ss          , Ss          , Ds          , Ss          , Ss          , Ss          , Ss          , Ss          , Ss          , Ss          , Ss          
Ss          ,Ss          , Ds          , Ss          , Ss          , Ss          , Ss          , Gg^Fet      , Ss          , Ggf         , Ss          , Ss          , Ds          , Ss          , Ss          , Ss          , Ss          , Ss          , Ss          , Ss          , Ss          , Ss          , Re          , Ss          , Ss          , Ss          , Ss          , Ss          , Ss          , Ss          , Ss          , Ss          , Gg          , Ss          , Ss          , Ss          , Ss          , Ss          , Ggf         , Ss          , Ss          , Ss          
Ss          ,Ss          , Ss          , Ds          , Ds          , Ss          , Ss          , Ss          , Ss          , Ggf         , Ss          , Ww          , Ss          , Ss          , Ss          , Ss          , Ss          , Ss          , Ds          , Ss          , Ss          , Ss          , Ss          , Re          , Re          , Ss          , Ss          , Ss          , Ss          , Ss          , Ss          , Ss          , Ss          , Ss          , Ss          , Ss          , Ggf         , Ggf         , Ss          , Ss          , Ss          , Ss          
Ss          ,Ss          , Ss          , Ss          , Ss          , Ss          , Ss          , Ss          , Ss          , Ss          , Ss          , Ss          , Ss          , Ss          , Ss          , Ss          , Ss          , Ss          , Ss          , Ds          , Ss          , Ss          , Ss          , Ss^Vhs      , Ss          , Ss          , Ss          , Ss          , Ss          , Gg^Fet      , Ss          , Ss          , Ggf         , Ss          , Ss          , Ss          , Ss          , Ss          , Ss          , Ss          , Ss          , Ss          
Ww          ,Ww          , Ss^Vhs      , Ss          , Ss          , Ss          , Ww          , Ss          , Ss          , Ss          , Ss          , Ss          , Ss          , Ss          , Ss          , Ds          , Ss          , Ss          , Ss          , Ss          , Ss          , Ss          , Ss          , Ss          , Ss          , Re          , Re          , Ss          , Ss          , Ggf         , Ss          , Ggf         , Ss          , Ds          , Ds          , Ss          , Ss          , Ss          , Ss          , Ss          , Ss          , Ss          
Ww          ,Ww          , Ss          , Ss          , Ss          , Ss          , Ss^Bw\      , Ww          , Ww          , Ss          , Ww          , Ww          , Ss          , Ss          , Ss          , Ss          , Ww          , Ww          , Ss          , Ss          , Ss          , Ss          , Ss          , Ss          , Ss          , Ss          , Ss          , Re          , Re          , Ss          , Ss          , Ss          , Ss          , Ss          , Ss          , Ss          , Ss          , Ss          , Ss          , Ss          , Ww          , Ww          
Wo          ,Wo          , Chs         , Ww          , Ss          , Ww          , Ss          , Ss          , Ww          , Ww          , Wo          , Ww          , Ww          , Ss          , Ss^Bw|      , Ww          , Ww^Vm       , Ww          , Ww          , Ss          , Ss          , Ss          , Ww          , Ss          , Ss          , Ss          , Ss          , Ss          , Ss          , Re          , Re          , Ss          , Ss          , Ss^Vhs      , Ww          , Ww          , Ww          , Ss          , Ss          , Ss          , Ww          , Ww          
Ww          ,Ww          , Ww^Bw|      , Ss          , Ww          , Ww          , Ss          , Ss          , Ss          , Ss^Vhs      , Ss          , Ww          , Ww          , Ww          , Ss          , Ww          , Ww          , Ww          , Ww          , Ww          , Ww          , Ss          , Ww          , Ww          , Ss          , Ss          , Ww          , Ss          , Ss          , Ss          , Ss          , Re          , Ss          , Ww          , Ss          , Ww          , Ss^Vhs      , Ww          , Ww          , Ww          , Ww          , Ww          
Ww          ,Ww          , Ww^Bw|      , Ww          , Ww          , Ss          , Ss          , Ss          , Ss          , Ss          , Ss          , Ww          , Ss          , Ss          , Ss          , Ss          , Ss          , Ss          , Ss          , Ss          , Ss          , Ww          , Ss^Vhs      , Ww          , Ww          , Ww          , Ss          , Ww          , Ss          , Ss          , Ss          , Ss          , Ss          , Re          , Ss          , Ss          , Ss^Bw|      , Ss          , Ss          , Ww          , Ss          , Ss          
Ww          ,Ww          , Ww^Bw|      , Ww          , Ww          , Ss          , Ss          , Ss          , Ss          , Ss          , Ss          , Ww          , Ss          , Ss          , Ss          , Ss          , Ss          , Ss          , Ss          , Ss          , Ss          , Ww          , Ss      , Ww          , Ww          , Ww          , Ss          , Ww          , Ss          , Ss          , Ss          , Ss          , Ss          , Re          , Ss          , Ss          , Ss^Bw|      , Ss          , Ss          , Ww          , Ss          , Ss          
